"lang"
{
"Language"	"pirate"
"Tokens"
{
"DOTA_WearableType_Daggers"	"Daggers"
"DOTA_WearableType_Glaives"	"Glaives"
"DOTA_WearableType_Hair"	"Hair"
"DOTA_WearableType_Mask"	"Mask"
"DOTA_WearableType_Boots"	"Boots"
"DOTA_WearableType_Hands"	"Hands"
"DOTA_WearableType_Head"	"head"
"DOTA_WearableType_Mace"	"Mace"
"DOTA_WearableType_Gauntlet"	"Gauntlet"
"DOTA_WearableType_Shoulder"	"shoulder"
"DOTA_WearableType_Bow"	"Bow"
"DOTA_WearableType_Quiver"	"Quiver"
"DOTA_WearableType_Shield"	"Shield"
"DOTA_WearableType_Horns"	"Horns"
"DOTA_WearableType_Beard"	"Beard"
"DOTA_WearableType_Necklace"	"Necklace"
"DOTA_WearableType_Fish_Treat"	"Fish Treat"
"DOTA_WearableType_Meathook"	"Meathook"
"DOTA_WearableType_Offhand_weapon"	"Offhand Weapon"
"DOTA_WearableType_Back"	"backside"
"DOTA_WearableType_offhand"	"offhand"
"DOTA_WearableType_arms"	"Arms"
"DOTA_WearableType_New_Item"	"New Loot"
"DOTA_WearableType_Pauldrons"	"Pauldrons"
"DOTA_WearableType_Chain_Weapon"	"Chained Weaponry"
"DOTA_WearableType_Helm"	"Helm"
"DOTA_WearableType_Pegleg"	"Pegleg"
"DOTA_WearableType_Sword"	"Cutlass"
"DOTA_WearableType_Hat"	"Hat"
"DOTA_WearableType_Toga"	"Toga"
"DOTA_WearableType_Hand"	"Hand"
"DOTA_WearableType_Taunt"	"Mock"
"DOTA_WearableType_Skin"	"Skin"
"DOTA_WearableType_Alternate_Ultimate"	"Diff'rent Ultimate"
"DOTA_WearableType_Alternate_Attack"	"Diff'rent Attack"
"DOTA_WearableType_Pauldron"	"Pauldron"
"DOTA_WearableType_Spaulder"	"Spaulder"
"DOTA_WearableType_Squishy_Hat"	"Squishy Hat"
"DOTA_WearableType_Bracers"	"Bracers"
"DOTA_WearableType_Robe"	"Robe"
"DOTA_WearableType_Headdress"	"Headdress"
"DOTA_WearableType_Mailed_Skirt"	"Mailed Skirt"
"DOTA_WearableType_Hat_and_Hair"	"Hat an' Hair"
"DOTA_WearableType_Shoes"	"Boots"
"DOTA_WearableType_Spikes"	"Spikes"
"DOTA_WearableType_Bone_Helm"	"Bone Helm"
"DOTA_WearableType_Mine"	"Mine"
"DOTA_WearableType_Fins"	"Fins"
"DOTA_WearableType_Axe"	"Hatchet"
"DOTA_WearableType_Shoulder_Guard"	"Shoulder Guard"
"DOTA_WearableType_Cloak_and_Tunic"	"Cloak an' Tunic"
"DOTA_WearableType_Hammer"	"Hammer"
"DOTA_WearableType_Dead_Shark"	"Dead Shark"
"DOTA_WearableType_Finished_Lunch"	"Finished Lunch"
"DOTA_WearableType_Bone_Club"	"Bone Club"
"DOTA_WearableType_Makeshift_Weapon"	"Makeshift Weapon"
"DOTA_WearableType_Shoulderguard"	"Shoulderguard"
"DOTA_WearableType_Fancy_Pantaloons"	"Fancy Pantaloons"
"DOTA_WearableType_Cloth_Bracer"	"Cloth Bracer"
"DOTA_WearableType_Stuffed_Toy"	"Stuffed Toy"
"DOTA_WearableType_Staff"	"Staff"
"DOTA_WearableType_Gruesome_Trophies"	"Gruesome Trophies"
"DOTA_WearableType_Hood"	"Hood"
"DOTA_WearableType_Shuriken"	"Razor"
"DOTA_WearableType_Mancatcher"	"Mancatcher"
"DOTA_WearableType_Apron"	"Apron"
"DOTA_WearableType_Armlet"	"Band"
"DOTA_WearableType_Scepter"	"Rod"
"DOTA_WearableType_Abomination"	"Execration"
"DOTA_WearableType_Greaves"	"Greaves"
"DOTA_WearableType_Saw"	"Saw"
"DOTA_WearableType_Hook"	"Hook"
"DOTA_WearableType_Abdomen"	"Belly"
"DOTA_WearableType_Sect_Pauldron"	"Sect Pauldron"
"DOTA_WearableType_Sect_Helm"	"Sect Skull Cap"
"DOTA_WearableType_Sect_Sword"	"Sect Cutlass"
"DOTA_WearableType_Flag"	"Flag"
"DOTA_WearableType_Blade_RightHand"	"Blade, Right-Hand"
"DOTA_WearableType_Blade_LeftHand"	"Blade, Left-Hand"
"DOTA_WearableType_Sect_Cape"	"Sect Cape"
"DOTA_WearableType_Sect_Skirt"	"Sect Skirt"
"DOTA_WearableType_Sect_Gauntlet"	"Sect Glove"
"DOTA_WearableType_Scarf"	"Scarf"
"DOTA_WearableType_Leather_Pants"	"Snakeskin Leggin's"
"DOTA_WearableType_Blade_RightHanded"	"Blade, Right-Handed"
"DOTA_WearableType_Talisman"	"Trinket"
"DOTA_WearableType_Garland"	"Frilly Thing"
"DOTA_WearableType_Exort_Cape"	"Exort Cape"
"DOTA_WearableType_Exort_Bracer"	"Exort Bracer"
"DOTA_WearableType_Exort_Crest"	"Exort Crest"
"DOTA_Item"	"Loot Ye Wear"
"DOTA_Custom_Courier"	"Courier"
"DOTA_Custom_HexModel"	"Yer Hex Animal"
"DOTA_WearableType_Announcer"	"Announcer"
"DOTA_WearableType_Custom_Courier"	"Courier"
"DOTA_WearableType_MegaKills"	" "
"DOTA_TreasureChest_Type"	"Booty"
"DOTA_WearableType_Tool"	"Tool"
"DOTA_WearableType_Battle_Bonus"	"Battle Bonus"
"DOTA_Item_Gift"	" Parcel"
"DOTA_WearableType_Gift"	"Parcel"
"DOTA_WearableType_Strange_Essence"	"Strange Essence"
"DOTA_WearableType_LeagueViewPass"	" "
"DOTA_WearableType_Bundle"	"Bundle"
"DOTA_Wearable_Riki_DefaultWeapon"	"Riki's Daggers"
"DOTA_Item_AntiMages_Glaives"	"Anti-Mage's Glaives"
"DOTA_Item_Desc_AntiMages_Glaives"	" "
"DOTA_Item_Axes_Axe"	"Axe's Axe"
"DOTA_Wearable_Axe_DefaultArmor"	"Axe's Shoulderpad"
"DOTA_Wearable_Axe_DefaultHair"	"Axe's Ponytail"
"DOTA_Item_Axes_Belt"	"Axe's Belt"
"DOTA_Wearable_Jugg_DefaultMask"	"Juggernaut's Mask"
"DOTA_Wearable_Jugg_DefaultWeapon"	"Juggernaut's Weapon"
"DOTA_Wearable_Jugg_DefaultCape"	"Juggernaut's Cape"
"DOTA_Wearable_Jugg_DefaultBracers"	"Juggernaut's Bracers"
"DOTA_Item_Kunkkas_Boots"	"Kunkka's Boots"
"DOTA_Item_Kunkkas_Hands"	"Kunkka's Hands"
"DOTA_Item_Kunkkas_Sword"	"Kunkka's Cutlass"
"DOTA_Item_Omniknights_Bracers"	"Omniknight's Bracers"
"DOTA_Item_Desc_Bracers"	"Omniknight's worn out bracers"
"DOTA_Item_Kunkkas_Head"	"Kunkka's Head"
"DOTA_FacelessVoid_Default_Weapon"	"Faceless Void's Weapon"
"DOTA_Wearable_Sven_DefaultHead"	"Sven's Mask"
"DOTA_Wearable_Sven_DefaultSword"	"Sven's Sword"
"DOTA_Wearable_Sven_DefaultBelt"	"Sven's Belt"
"DOTA_Wearable_Sven_DefaultGauntlet"	"Sven's Gauntlet"
"DOTA_Wearable_Sven_DefaultShoulder"	"Sven's Spaulder"
"DOTA_Wearable_Windrunner_DefaultHead"	"Windranger's Head"
"DOTA_Wearable_Windrunner_DefaultBow"	"Windranger's Bow"
"DOTA_Wearable_Windrunner_ShoulderPads"	"Windranger's Shoulder Pads"
"DOTA_Wearable_Windrunner_Cape"	"Windranger's Cape"
"DOTA_Wearable_Windrunner_DefaultQuiver"	"Windranger's Quiver"
"DOTA_Item_Queen_of_Pains_Weapon"	"Queen o' Pain's Weapon"
"DOTA_Wearable_Silencer_DefaultWeapon"	"Silencer's Weapon"
"DOTA_Wearable_Silencer_DefaultShield"	"Silencer's Shield"
"DOTA_Wearable_Furion_DefaultWeapon"	"Prophet's Staff"
"DOTA_Wearable_Furion_DefaultHorns"	"Prophet's Horns"
"DOTA_Wearable_Furion_DefaultBeard"	"Prophet's Beard"
"DOTA_Wearable_Furion_DefaultCape"	"Prophet's Cape"
"DOTA_Wearable_Furion_DefaultNecklace"	"Prophet's Necklace"
"DOTA_Item_Tidehunters_Bracer"	"Tidehunter's Bracer"
"DOTA_Item_Tidehunters_Belt"	"Tidehunter's Belt"
"DOTA_Item_Tidehunters_Anchor"	"Tidehunter's Anchor"
"DOTA_Item_Tidehunters_Lunch"	"Tidehunter's Lunch"
"DOTA_Wearable_CrystalMaiden_Default_Cape"	"Crystal Maiden's Cape"
"DOTA_Wearable_CrystalMaiden_Default_Shoulder_Pads"	"Crystal Maiden's Shoulder Pads"
"DOTA_Wearable_CrystalMaiden_Default_Weapon"	"Crystal Maiden's Stick"
"DOTA_Wearable_CrystalMaiden_Default_Boots_and_Cuffs"	"Crystal Maiden's Boots & Cuffs"
"DOTA_Item_Omniknights_Shoulders"	"Omniknight's Pauldrons"
"DOTA_Item_Omniknights_Cape"	"Omniknight's Cape"
"DOTA_Item_Omniknights_Weapon"	"Omniknight's Weapon"
"DOTA_Item_Desc_Omniknights_Hammer"	"Omniknight's rusty-lookin' hammer"
"DOTA_Item_Omniknights_Head"	"Omniknight's Head"
"DOTA_Item_Omniknights_Hair"	"Omniknight's Hair"
"DOTA_Item_Pudges_Rusty_Meathook"	"Pudge's Rusty Meathook"
"DOTA_Item_Desc_Rusty_Meathook"	"A vicious an' rusty-lookin' meat hook."
"DOTA_Item_Invokers_Cape"	"Invoker's Cape"
"DOTA_Item_Prophets_Bracers"	"Prophet's Bracers"
"DOTA_Item_Desc_Copy_of_Prophets_Horns"	" "
"DOTA_Item_Bounty_Hunters_Weapon"	"Bounty Hunter's Weapon"
"DOTA_Item_Desc_Unnamed_New_Item"	"Arr, this 'ere loot ain't described or nothin'."
"DOTA_Item_Bounty_Hunters_Offhand_Weapon"	"Bounty Hunter's Offhand Weapon"
"DOTA_Item_Desc_Copy_of_RWeapon"	"Arr, this 'ere loot ain't described or nothin'."
"DOTA_Item_Bounty_Hunters_Back"	"Bounty Hunter's Back"
"DOTA_Item_Desc_Copy_of_LWeapon"	"Arr, this 'ere loot ain't described or nothin'."
"DOTA_Item_Armor"	"Bounty Hunter's Armor"
"DOTA_Item_Desc_Copy_of_Backpack"	"Arr, this 'ere loot ain't described or nothin'."
"DOTA_Item_Bounty_Hunters_Shoulder"	"Bounty Hunter's Shoulder"
"DOTA_Item_Desc_Copy_of_Armor"	"Arr, this 'ere loot ain't described or nothin'."
"DOTA_Item_Bounty_Hunters_Bandana"	"Bounty Hunter's Bandana"
"DOTA_Item_Desc_Copy_of_BWeapon"	"Arr, this 'ere loot ain't described or nothin'."
"DOTA_Item_Clinkz_Skull"	"Clinkz Skull"
"DOTA_Item_Desc_Clinkz_Skull"	"Clinkz ol' skull"
"DOTA_Item_Clinkz_Bow"	"Clinkz Bow"
"DOTA_Item_Desc_Clinkz_Bow"	"Clinkz ol' Bow"
"DOTA_Item_Clinkz_Shoulder_Pads"	"Clinkz Shoulder Pads"
"DOTA_Item_Desc_Clinkz_Shoulder_Pads"	"Clinkz usual Shoulder Pads"
"DOTA_Item_Clinkz_Quiver"	"Clinkz Quiver"
"DOTA_Item_Desc_Clinkz_Quiver"	"Clinkz ol' Quiver"
"DOTA_Item_Clinkz_Horns"	"Clinkz Horns"
"DOTA_Item_Desc_Clinkz_Horns"	"Clinkz ol' Horns"
"DOTA_Item_Clinkz_Gloves"	"Clinkz Gloves"
"DOTA_Item_Desc_Copy_of_Clinkz_Skull"	"Clinkz ol' Skull"
"DOTA_Wearable_Jugg_DefaultLegs"	"Juggernaut's Legs"
"DOTA_Item_Dragon_Knights_Helmet"	"Dragon Knight's Helmet"
"DOTA_Item_Desc_Copy_of_Juggernauts_Legs"	" "
"DOTA_Item_Dragon_Knights_Shoulder_Armor"	"Dragon Knight's Spaulders"
"DOTA_Item_Dragon_Knights_Bracers"	"Dragon Knight's Bracers"
"DOTA_Item_Desc_Copy_of_Dragon_Knights_Shoulder_Armor"	" "
"DOTA_Item_Dragon_Knights_Weapon"	"Dragon Knight's Weapon"
"DOTA_Item_Dragon_Knights_Offhand"	"Dragon Knight's Offhand"
"DOTA_Item_Dragon_Knights_Skirt"	"Dragon Knight's Skirt"
"DOTA_Item_Desc_Copy_of_Dragon_Knights_Offhand"	" "
"DOTA_Item_Blood_Seekers_Weapon"	"Blood Seeker's Weapon"
"DOTA_Item_Desc_Copy_of_Dragon_Knights_Skirt"	" "
"DOTA_Item_Blood_Seekers_Headdress"	"Blood Seeker's Headdress"
"DOTA_Item_Blood_Seekers_Offhand_Weapon"	"Blood Seeker's Offhand Weapon"
"DOTA_Item_Desc_Copy_of_Blood_Seekers_Headdress"	" "
"DOTA_Item_Blood_Seekers_Necklace"	"Blood Seeker's Necklace"
"DOTA_Item_Desc_Copy_of_Blood_Seekers_Offhand_Weapon"	" "
"DOTA_Item_Blood_Seekers_Cape"	"Blood Seeker's Cape"
"DOTA_Item_Desc_Copy_of_Blood_Seekers_Necklace"	" "
"DOTA_Item_Blood_Seekers_Bracers"	"Blood Seeker's Bracers"
"DOTA_Item_Desc_Copy_of_Blood_Seekers_Cape"	" "
"DOTA_Item_Drows_Bracers"	"Drow's Bands"
"DOTA_Item_Desc_Copy_of_Blood_Seekers_Bracers"	" "
"DOTA_Item_Drows_Cape"	"Drow's Cloak"
"DOTA_Item_Desc_Copy_of_Drows_Bracers"	" "
"DOTA_Item_Drows_Bow"	"Drow's Bow"
"DOTA_Item_Desc_Copy_of_Drows_Cape"	" "
"DOTA_Item_Drows_Leg_Armor"	"Drow's Leg Armor"
"DOTA_Item_Drows_Quiver"	"Drow's Quiver"
"DOTA_Item_Desc_Copy_of_Drows_Leg_Armor"	" "
"DOTA_Item_Drows_Shoulder_Armor"	"Drow's Shoulder Armor"
"DOTA_Item_Desc_Copy_of_Drows_Quiver"	" "
"DOTA_Item_Kunkkas_Spyglass"	"Kunkka's Spyglass"
"DOTA_Item_Desc_Copy_of_Kunkkas_Head"	" "
"DOTA_Item_Queen_of_Pains_Wings"	"Queen o' Pain's Wings"
"DOTA_Item_Desc_Copy_of_Queen_of_Pains_Weapon"	" "
"DOTA_Item_Queen_of_Pains_Armor"	"Queen o' Pain's Armor"
"DOTA_Item_Desc_Copy_of_Queen_of_Pains_Wings"	" "
"DOTA_Item_Queen_of_Pains_Hair"	"Queen o' Pain's Hair"
"DOTA_Item_Desc_Copy_of_Queen_of_Pains_Armor"	" "
"DOTA_Item_Ursas_Helmet"	"Ursa's Helmet"
"DOTA_Item_Desc_Copy_of_Queen_of_Pains_Hair"	" "
"DOTA_Item_Ursas_Fur"	"Ursa's Fur"
"DOTA_Item_Desc_Copy_of_Ursas_Helmet"	" "
"DOTA_Item_Ursas_Bracers"	"Ursa's Wraps"
"DOTA_Item_Desc_Copy_of_Ursas_Fur"	" "
"DOTA_Item_Ursas_Skirt"	"Ursa's Skirt"
"DOTA_Item_Desc_Copy_of_Ursas_Bracers"	" "
"DOTA_Item_Invokers_Shoulder"	"Invoker's Shoulder"
"DOTA_Item_Facelesss_Head"	"Faceless's Head"
"DOTA_Item_Facelesss_Shoulder"	"Faceless's Shoulder"
"DOTA_Item_Facelesss_Bracer"	"Faceless's Bracer"
"DOTA_Item_Facelesss_Belt"	"Faceless's Belt"
"DOTA_Item_Witch_Doctors_Head"	"Witch Doctor's Head"
"DOTA_Item_Witch_Doctors_Bag"	"Witch Doctor's Bag"
"DOTA_Item_Witch_Doctors_Belt"	"Witch Doctor's Belt"
"DOTA_Item_Witch_Doctors_Staff"	"Witch Doctor's Staff"
"DOTA_Item_Invokers_Head"	"Invoker's Head"
"DOTA_Item_Invokers_Hair"	"Invoker's Hair"
"DOTA_Item_Invokers_Bracer"	"Invoker's Bracer"
"DOTA_Item_Broodmothers_Hair"	"Broodmother's Hair"
"DOTA_Item_Broodmothers_Legs"	"Broodmother's Legs"
"DOTA_Item_Broodmothers_Abdomen"	"Broodmother's Abdomen"
"DOTA_Item_Meepos_Weapon"	"Meepo's Weapon"
"DOTA_Item_Ogremagis_Weapon"	"Ogremagi's Weapon"
"DOTA_Item_Desc_Copy_of_weapon"	"Arr, this 'ere loot ain't described or nothin'."
"DOTA_Item_Spirit_Breakers_Head"	"Spirit Breaker's Head"
"DOTA_Item_Lone_Druids_Hair"	"Lone Druid's Hair"
"DOTA_Item_Desc_head"	"typical hair"
"DOTA_Item_Lone_Druids_Shoulder_Armor"	"Lone Druid's Shoulder Armor"
"DOTA_Item_Desc_Lone_Druids_Shoulder_Armor"	"usual shoulder armor"
"DOTA_Item_Lone_Druids_Bracers"	"Lone Druid's Bracers"
"DOTA_Item_Desc_Lone_Druids_Bracers"	"usual wraps"
"DOTA_Item_Lone_Druids_Poncho"	"Lone Druid's Poncho"
"DOTA_Item_Desc_Lone_Druids_Poncho"	"usual bit o' flimsy armor"
"DOTA_Item_Spirit_Breakers_Horns"	"Spirit Breaker's Horns"
"DOTA_Item_Desc_Copy_of_Spirit_Breakers_Head"	"Arr, this 'ere loot ain't described or nothin'."
"DOTA_Item_Spirit_Breakers_Shoulder_Armor"	"Spirit Breaker's Shoulder Armor"
"DOTA_Item_Desc_Copy_of_Spirit_Breakers_Horns"	"Arr, this 'ere loot ain't described or nothin'."
"DOTA_Item_Spirit_Breakers_Mace"	"Spirit Breaker's Mace"
"DOTA_Item_Desc_Copy_of_Spirit_Breakers_Shoulder_Armor"	"Arr, this 'ere loot ain't described or nothin'."
"DOTA_Item_Spirit_Breakers_Tail"	"Spirit Breaker's Tail"
"DOTA_Item_Desc_Copy_of_Spirit_Breakers_Mace"	"Arr, this 'ere loot ain't described or nothin'."
"DOTA_Item_Spirit_Breakers_Bracers"	"Spirit Breaker's Bracers"
"DOTA_Item_Desc_Copy_of_Spirit_Breakers_Tail"	"Arr, this 'ere loot ain't described or nothin'."
"DOTA_Item_Spirit_Breakers_Lower_Armor"	"Spirit Breaker's Lower Armor"
"DOTA_Item_Desc_Copy_of_Spirit_Breakers_Bracers"	"Arr, this 'ere loot ain't described or nothin'."
"DOTA_Item_Alchemists_Goblin_Body"	"Alchemist's Goblin Body"
"DOTA_Item_Alchemists_Weapon"	"Alchemist's Weapon"
"DOTA_Item_Alchemists_Saddle"	"Alchemist's Saddle"
"DOTA_Item_Alchemists_Gauntlet"	"Alchemist's Gauntlet"
"DOTA_Item_Alchemists_Goblin_Hat"	"Alchemist's Goblin Hat"
"DOTA_Item_Alchemists_Left_Bottle"	"Alchemist's Left Bottle o' Rum"
"DOTA_Item_Alchemists_Goblin_Head"	"Alchemist's Goblin Head"
"DOTA_Item_Alchemists_Ogre_Head"	"Alchemist's Ogre Head"
"DOTA_Item_Alchemists_Shoulder_Bottle"	"Alchemist's Other Bottle o' Rum"
"DOTA_Item_Phantom_Lancers_Legs"	"Phantom Lancer's Legs"
"DOTA_Item_Desc_Phantom_Lancers_Legs"	"These boots were made fer walkin'."
"DOTA_Item_Phantom_Lancers_Head"	"Phantom Lancer's Head"
"DOTA_Item_Phantom_Lancers_Belt"	"Phantom Lancer's Belt"
"DOTA_Item_Phantom_Lancers_Gauntlet"	"Phantom Lancer's Gauntlet"
"DOTA_Item_Phantom_Lancers_Shoulderpad"	"Phantom Lancer's Shoulderpad"
"DOTA_Item_Phantom_Lancers_Necklace"	"Phantom Lancer's Necklace"
"DOTA_Item_Desc_Phantom_Lancers_Necklace"	"E'en pirates like t' look like a million doubloons."
"DOTA_Item_Phantom_Lancers_Weapon"	"Phantom Lancer's Weapon"
"DOTA_Item_Ogremagis_Cape"	"Ogremagi's Cape"
"DOTA_Item_Desc_Copy_of_Ogremagis_Weapon"	"Arr, this 'ere loot ain't described or nothin'."
"DOTA_Item_Ogremagis_Bracers"	"Ogremagi's Bracers"
"DOTA_Item_Desc_Copy_of_Ogremagis_Cape"	"Arr, this 'ere loot ain't described or nothin'."
"DOTA_Item_Ogremagis_Hats"	"Ogremagi's Big Ol' Hats"
"DOTA_Item_Desc_Copy_of_Ogremagis_Bracers"	"Arr, this 'ere loot ain't described or nothin'."
"DOTA_Item_Ogremagis_Belt"	"Ogremagi's Belt"
"DOTA_Item_Desc_Copy_of_Ogremagis_Hats"	"Arr, this 'ere loot ain't described or nothin'."
"DOTA_Item_Wich_Doctors_Horn_Mask"	"Witch Doctor's Horn Mask"
"DOTA_Item_Pangolin_Shoulder_Armor"	"Pangolin Pads"
"DOTA_Item_Desc_Pangolin_Shoulder_Armor"	"Dun be fool'd by th' look o' these spaulders. Bloody things can take a beatin' an' keep movin'. Is why we used fire!"
"DOTA_Item_Witch_Doctors_Ribcage_Backpack"	"Witch Doctor's Ribcage Backpack"
"DOTA_Item_The_Blood_Chaser"	"Th' Chain Chopper"
"DOTA_Item_Desc_The_Blood_Chaser"	"Some smart fella figured 'e could make an axe e'en longer by jus' cuttin' it int' three parts an' puttin' chain there. Jus' make sure ye dun go an' 'it yerself."
"DOTA_Item_Timestopper"	"Watchbreaker"
"DOTA_Wearable_FacelessVoid_Timestopper_Desc"	"Like me mateys tell me: If bein' scurvy-ridden an' dirty dun scare yer foe, jus' stab 'em. Solves all yer problems!"
"DOTA_Wearable_Dazzle_TrolltoothNecklace"	"Trolltooth Necklace"
"DOTA_Wearable_Dazzle_TrolltoothNecklace_Desc"	"A neat collection o' teeth that fell out o' yer head after a few pub brawls gone awry."
"DOTA_Item_Dragonclaw_Hook"	"Th' Dutchman's Finger"
"DOTA_Item_Desc_Dragonclaw_Hook"	"Th' bone screams wit' th' shouts of a million drown'd souls...or it may be from that thar mob comin' at us."
"DOTA_Item_Demon_Blood_Helm"	"Demon Blood Helm"
"DOTA_Item_Desc_Demon_Blood_Helm"	"A dead symbol fer a dead god. It used t' resemble th' visage o' a demonic war god. Now it jus' be a useful helm."
"DOTA_Wearable_Axe_Demon_Blood_Armor"	"Demon Blood Heavy Pauldrons"
"DOTA_Item_Desc_Demon_Blood_Armor"	"Th' armor carries th' stain o' blood, yet it still be warm t' th' touch.."
"DOTA_Item_Demon_Blood_Guard"	"Demon Blood Guard"
"DOTA_Item_Desc_Demon_Blood_Guard"	"Th' battle raged on an' th' Red Mist proved victorious. Th' battle would not go unnoticed as th' waters burn'd an' boil'd red. Demons charadin' 'as people suddenly vanished int' dust in jus' a few ticks."
"DOTA_Wearable_Kunkka_Pegleg"	"Me Good Leg"
"DOTA_Item_Desc_Pegleg_of_the_Cursed_Pirate"	"Arr, ye found me good leg! Now jus' find me good eye.."
"DOTA_Item_ThreeFold_Mien_of_the_Boar_God"	"Masque o' th' Boar"
"DOTA_Item_Desc_ThreeFold_Mien_of_the_Boar_God"	"A tough mask that vaguely resembles some kind o' boar. Thar be some scribbles in 'ere too: four-seven-twelve?"
"DOTA_Item_SevenSealed_the_Fur_Bracer"	"Ordinary Fur Bracers"
"DOTA_Item_Desc_SevenSealed_the_Fur_Bracer"	"It jus' be bracers wit' fur on 'em. Quite warm an' quite comfy t' 'ave durin' round trips t' th' northern seas. Some lads jus' like fancy things."
"DOTA_Item_TwelveTusks_the_Cape_of_Boars"	"Tusked Boar-skin Cape"
"DOTA_Item_Desc_TwelveTusks_the_Cape_of_Boars"	"Looks like ye were in th' middle o' th skinnin' process an' then decided t' shove as many tusks int' th' skin as ye could until it was done. That or it tried t' fight ye an' ye won."
"DOTA_Item_FourFangs_the_Swordbreaker"	"Tribal's Serrated Sword"
"DOTA_Item_Desc_FourFangs_the_Swordbreaker"	"This lil' diddy 'as vicious curves t' really carve an' cut away at yer foe. Also good at' sawin' wood!"
"DOTA_Wearable_Kunkka_Bandana"	"Cap'ns Workin' Cap"
"DOTA_Item_Desc_Pride_of_the_Crew"	"Arr, e'en th' Cap'n 'elps us 'round th' place."
"DOTA_Wearable_Kunkka_Bicorne_Hat"	"Royal Admiral's Bicorne"
"DOTA_Item_Desc_Royal_Admirals_Bicorne"	"A fine lookin' bicorne we stole off some privateer's corpse."
"DOTA_Wearable_Kunkka_Tricorne_Hat"	"Gold-rimm'd Tricorne"
"DOTA_Item_Desc_Tricorne_of_the_Drowned"	"A finely shaped tricorne edged in some gold. Can't geddit off though..."
"DOTA_Wearable_Kunkka_Wavecrester"	"Wavesplitter"
"DOTA_Item_Desc_Wavecrester"	"Some kind o' aged harpoon wit' vicious hooks on th' end of it."
"DOTA_Item_Pact_of_GorThramak"	"Accord o' Gor-Thramak"
"DOTA_Item_Desc_Pact_of_GorThramak"	"In his ventures 'cross th' Outer Worlds, lookin' fer artifacts an' loot, th' warlock Demnok Lannik has sign'd many a dark pact. Countless terrible entities owe him their favor. Gor-Thramak, th' Sanguinated Fiend, be one such sorry sap. In a time o' dire need, th' Warlock might call upon th' Fiend's Avatar - th' Rendbeast - t' aid in th' grimy work o' slaughter an' murder."
"DOTA_Wearable_Axe_Berserkers_Pauldron"	"Berserker's Pauldron"
"DOTA_Item_Desc_Berserkers_Pauldron"	"\"No matter 'ow many heads I cleave, thar be more t' cut open!\""
"DOTA_Wearable_Axe_Berserkers_Helm"	"Berserker's Helm"
"DOTA_Item_Desc_Berserkers_Helm"	"I once look'd a man in th' eye wearin' this 'ere helm. I be missin' an eye now. Dun tempt th' bugger!"
"DOTA_Wearable_Axe_Berserkers_Belt"	"Berserker's Belt"
"DOTA_Item_Desc_Berserkers_Belt"	"\"Time t' cut.\""
"DOTA_Item_Coat_of_the_Elder_Grove"	"Mantle o' th' Grove"
"DOTA_Item_Desc_Coat_of_the_Elder_Grove"	"A coat o' leaves that dun really feel good t' put on yer self. Not t' mention bugs keep eatin' int' it!"
"DOTA_Item_Horns_of_the_Forest_Lord"	"Horns o' th' Forest Lord"
"DOTA_Item_Desc_Ceremonial_Horns"	"Th' bodily form o' Nature's Wrath may select whatever guise 'e pleases. Sometimes he opts fer a tree, other times a predator, or - should't suit him - prey."
"DOTA_Item_Toga_of_the_PeaceBringer"	"Hermit's Bed Sheets"
"DOTA_Item_Desc_Toga_of_the_PeaceBringer"	"Some bed sheet 'e found."
"DOTA_Item_Luxuriant_ChinFoliage"	"Kingly Beard o' Beards"
"DOTA_Item_Desc_Luxuriant_ChinFoliage"	"I dun care what anyone says, this beard put all other beards t' shame. Jus' look at how long an' green it be!"
"DOTA_Item_Horns_of_Noblesse"	"Horns o' th' Noble"
"DOTA_Item_Desc_Horns_of_Noblesse"	"Quite th' horny set fer a king."
"DOTA_Item_Cape_of_Verdant_Dreaming"	"Cape o' th' Wood"
"DOTA_Item_Desc_Cape_of_Verdant_Dreaming"	"Wrapp'd in th' power o' th' ancient woods."
"DOTA_Item_Runestaff_of_Verodicia"	"Verodicia's Wooden Walker"
"DOTA_Item_Desc_Prophets_Runestaff_of_Verodicia"	"Many dun know this, but Verodicia was really some ol' cripple that used this t' get places."
"DOTA_Item_Runed_Ailettes"	"Runed Ailettes"
"DOTA_Item_Desc_Runed_Ailettes"	"Arr, th' glowin' runes inscribed in these give any lad wearin' them th' power t' lift e'en th' heaviest burdens off their back."
"DOTA_Item_Lucky_Tooth_Necklace"	"Lucky Tooth Necklace"
"DOTA_Item_Desc_Lucky_Tooth_Necklace"	"A necklace o' rare leviathan's cut teeth."
"DOTA_Item_Captains_Hook"	"Hook o' th' Captain"
"DOTA_Item_Desc_Captains_Hook"	"In waters as treacherous as those surroundin' th' Tremblin' Isle, even th' most skilful an' fortuitous pirate suffers an' injury or two."
"DOTA_Item_Tayrnhelm_of_the_Swordmaster"	"Tayrnhelm o' th' Swordmaster"
"DOTA_Item_Desc_Tayrnhelm_of_the_Swordmaster"	"Th' tall, serrated shafts along th' side are supposed t' bolster th wearer's sense o' hearin'."
"DOTA_Item_Girth_of_the_Swordmaster"	"Girth o' th' Swordmaster"
"DOTA_Item_Desc_Girth_of_the_Swordmaster"	"Aye, it's not th' most comfortable o' armor pieces, but equip it an' yer thigh is sure t' remain safe."
"DOTA_Item_Fluted_Guard_of_the_Swordmaster"	"Fluted Guard o' th' Swordmaster"
"DOTA_Item_Desc_Fluted_Guard_of_the_Swordmaster"	"Most pirates reckoned this piece were just too big an' bulky fer use in battle. Then Sven impaled an ogre on th' shoulder spikes, an' opinion soon changed."
"DOTA_Item_Grip_of_the_Swordmaster"	"Grip o' th' Swordmaster"
"DOTA_Item_Desc_Grip_of_the_Swordmaster"	"Carefully construct'd t' guide a foe's blade away from th' shoulder, or t' catch it mid-swing. Many a pirate has fallen after underestimatin' such a simple bit o' kit."
"DOTA_Item_Meranth_Executioners_Blade"	"Cap'n Meranth's Executioner's Blade"
"DOTA_Item_Desc_Meranth_Executioners_Blade"	"Cap'n Meranth's blade was that o' somethin' t' fear. One fell swoop an' ye'd be missin' yer 'ead or yer body. It also be good at divvyin' up meat."
"DOTA_Item_Taunt_Snipers_Celebration"	"Mock: Sniper's Celebration"
"DOTA_AnimTaunt_SniperTaunt_Desc"	"Celebrate a bit o' bloody murder or a big plunder by showin' yer excitement t' yer foe. He won't mind at all!"
"DOTA_Item_Taunt_Beautiful_Snowangel"	"Mock: Beautiful Snowangel"
"DOTA_AnimTaunt_CM_Snowangel_Desc"	"Crystal Maiden makes a snowangel! Dunno why."
"DOTA_Item_Taunt_Playful_Snowball"	"Mock: Playful Snowball"
"DOTA_AnimTaunt_CM_Snowball_Desc"	"Crystal Maiden throws a snowball! Throw a rock at 'er!"
"DOTA_Item_Taunt_Come_and_Get_It"	"Mock: Come an' Get It!"
"DOTA_Item_Taunt_Spider_Shuffle"	"Mock: Spider Shuffle"
"DOTA_AnimTaunt_Broodmother_Spin_Desc"	"Broodmother Spin Mock"
"DOTA_Item_Taunt_Good_Day_Sir"	"Mock: Good Day Sir!"
"DOTA_Item_Desc_Taunt_Good_Day_Sir"	" "
"DOTA_Item_Taunt_DoubleHeaded_Roar"	"Mock: Double-Headed Roar"
"DOTA_AnimTaunt_Jakiro_Roar_Desc"	"Jakiro Roar Mock"
"DOTA_Item_Taunt_Icemelter"	"Mock: Icemelter"
"DOTA_AnimTaunt_Jakiro_Icemelt_Desc"	"Jakiro Icemelt Mock"
"DOTA_Item_Taunt_Fish_Treat"	"Mock: Fishy Treat"
"DOTA_AnimTaunt_Tidehunter_Toss_Fish_Desc"	" "
"DOTA_Item_Wrath_of_the_Orca"	"Wrath o' th' Orca"
"DOTA_Item_Desc_Wrath_of_the_Orca"	"Nothin' yet."
"DOTA_Item_Taunt_Get_Burned"	"Mock: Get Scorch'd"
"DOTA_Item_Desc_Lina_Taunt__Get_Burned"	"Time t' get singed."
"DOTA_Item_Wuldastron_the_TwinBlade_of_Giants"	"Wuldastron th' Twin-Blade o' Giants"
"DOTA_Item_Desc_Wuldastron_the_TwinBlade_of_Giants"	"Few pirates could handle quite a blade."
"DOTA_Item_Ultimate_Belly_Flop"	"Ultimate: Drunken Flop"
"DOTA_Item_Desc_Belly_Flop"	"Gives Tidehunter a chance t' fall flat on his face when usin' his ultimate."
"DOTA_Item_Attack_Fish_Slap"	"Attack: Fish Slap"
"DOTA_Item_Desc_Attack_Fish_Slap"	"Th' Tidehunter holds back his anchor an' instead strikes foes wit' his fish. It's mostly fer humiliation."
"DOTA_Item_Taunt_The_Jig"	"Mock: Th' Jig"
"DOTA_Item_Desc_Taunt__The_Jig"	"Witch Doctor Victor's Jig"
"DOTA_Item_Taunt_You"	"Mock: Ye!"
"DOTA_Item_Taunt_Dive_Dive"	"Mock: Dive! Dive!"
"DOTA_Item_Taunt_Canonical_Blast"	"Mock: Canonical Blast"
"DOTA_Item_Desc_Taunt_Natures_Prophets_Bazooka"	"That *be* his staff and aye, he's pleased t've kill'd ye!"
"DOTA_Item_Taunt_Shredding_the_Lute_Invisible"	"Mock: Shreddin' th' Lute Invisible"
"DOTA_Item_Desc_Taunt_Natures_Prophets_Guitar_Windmill"	"Nature's Prophet makes some kind o' jigglin' motion t' commemorate yer death."
"DOTA_Item_Taunt_For_Death_and_Honor"	"Mock: Fer Death an' Honor"
"DOTA_Item_Taunt_Face_the_Juggernaut"	"Mock: Face th' Juggernaut"
"DOTA_Item_Desc_Taunt_Face_the_Juggernaut"	"Tell yer foes who ye be."
"DOTA_Item_Taunt_Tooting_the_Horn"	"Mock: Blowin' me Horn"
"DOTA_Item_Desc_Taunt_Tooting_the_Horn"	"Give th' corpse o' yer foe a nice lil' salute."
"DOTA_Item_Staff_of_the_TuskBereft"	"Tusk'd Staff"
"DOTA_Item_Desc_Prophets_Staff_of_the_Violators"	"Trees don't exist t' be made into wooden legs."
"DOTA_Item_Tusked_Bracers"	"Nature's Ferocity"
"DOTA_Item_Desc_Tusked_Bracers"	"Many would think th' Nature's Prophet be a thing o' leaf an' flower. They forget th' rending claws o' th' forest grizzly an' th' tearing tusks o' th' deep woods boars."
"DOTA_Item_Grand_Crown_of_the_Gigas"	"Great Crown o' th' Gigas"
"DOTA_Item_Sinorian_Sphere_Staff"	"Gemmed Cane"
"DOTA_Item_Taunt_Bo_Staff_Beckon"	"Mock: Bo Staff Beckon"
"DOTA_Item_Desc_Taunt_Natures_Prophets_Bo_Staff_Skills"	"Show off yer skills wit' th' staff"
"DOTA_Item_Taunt_Vaudville_Victory_Dance"	"Mock: Vaudville Victory Jig"
"DOTA_Item_Taunt_Murder_Lute"	"Mock: Murder Lute"
"DOTA_Item_Desc_Taunt_Natures_Prophets_Murder_Lute"	"He be bad at singin' so 'e jus' shouts: DIE!"
"DOTA_Item_Pauldron_of_AlFusha"	"Commodore Al-Fusha's Pauldron"
"DOTA_Item_Defender_of_the_Ivory_Isles"	"Ivory Glaive o' th' Isles"
"DOTA_Item_Desc_The_Ivory_Isles_Defender"	"Th' Isles be jus' that, isles. We only found it once an' it be overrun wit' thieves an' fools lookin' fer a fresh kill. Needless t' say, we walk'd away like kings. I got me this 'ere neato sword!"
"DOTA_Item_Visage_of_the_Ivory_Isles"	"Ivory Masque o' th' Isles"
"DOTA_Item_Desc_Visage_of_the_Ivory_Isles"	"A strange mask that be bloody 'eavy t' wear, but makes ye feel at peace an' yet an unstoppable force. We dun wear it now."
"DOTA_Item_Curled_RootStaff"	"Staff o' Scurvy"
"DOTA_Item_Desc_Curled_RootStaff"	"When scurvy be so bad, e'en th' wood curls."
"DOTA_Item_Flared_Wooden_Crest"	"Wooden Spaulders"
"DOTA_Item_Fireborn_Odachi"	"Glowin' Foreign Blade"
"DOTA_Item_Taunt_Kata_of_Foot_and_Earth"	"Mock: Kata o' Foot an' Earth"
"DOTA_Item_Doubly_Braided_Beard"	"Doubly Braided Beard"
"DOTA_Item_Desc_Doubly_Braided_Beard"	"'Cause one beard be hard t' braid an' three be full o' ticks."
"DOTA_Item_Druidic_Ritual_Crest"	"Strange Wooden Necklace"
"DOTA_Item_Desc_Druidic_Ritual_Crest"	"Only a few pirates can be seen toutin' this lil' trinket. Mostly 'cause they keep losin' th' blast'd things."
"DOTA_Item_Stoic_Mask_of_the_High_Plains"	"Skull Mask o' th' Goat"
"DOTA_Item_Desc_Stoic_Mask_of_the_High_Plains"	"Findin' a goat at sea be harder than findin' booty. Gettin' its skull while it be kickin' be 'arder."
"DOTA_Item_Wolf_Cape_of_the_High_Plains"	"Wolf Skin Cape"
"DOTA_Item_Desc_Wolf_Cape_of_the_High_Plains"	"Th' northern pirates tell tales o' vicious buggers that'll rip yer neck clean in one bite, but make fer warm capes. So we pillaged a village fer 'em."
"DOTA_Item_Aspect_Wraps_of_the_High_Plains"	"Furry Wolf Wraps"
"DOTA_Item_Desc_Aspect_Wraps_of_the_High_Plains"	"Wolf skin an' fur be nice an' all, but nothin' beats snakeskin pants."
"DOTA_Item_LongFang_the_Grey_Blade"	"Mighty-Fang th' Great Blade"
"DOTA_Item_Beard_of_Cycles"	"Beard o' Cycles"
"DOTA_Item_Modestly_Braided_Beard"	"Braided Beard o' Bushes"
"DOTA_Item_Taunt_Kata_of_Blade_and_Sky"	"Mock: Kata o' Blade an' Sky"
"DOTA_Item_Cuffs_of_Oak_and_Yew"	"Bracers o' Oak an' Yew"
"DOTA_Item_Desc_Cuffs_of_Oak_and_Yew"	"While sturdy an' protective, th' bloody things jus' keep givin' me splinters..."
"DOTA_Item_Kraken_Shell"	"Shell o' th' Kraken"
"DOTA_Item_Octopus_Hat"	"Octopus Garb"
"DOTA_Item_Desc_Octopus_Hat"	"'Tis tryin' t' ride int' battle? 'Tis tryin' t' fornicate with th' head? Can it alter th' thoughts o' th' Tidehunter? Only a feeder knows fer sure!"
"DOTA_Item_Grand_Claive_of_the_Unshamed"	"Grand Claive o' th' Unshamed"
"DOTA_Item_Wyrm_Shield_of_Uldorak"	"Cap'n Uldorak's Standard"
"DOTA_Item_Desc_Wyrm_Shield_of_Uldorak"	"Th' cap'n rarely went t' battle wit'out this at 'is side. Seems it didn't protect 'im from bein' skinn'd alive."
"DOTA_Item_Belt_o_Wicked_Badness"	"Belt o' Wick'd Badness"
"DOTA_Item_Kimono_of_the_Ebony_Tower"	"Shred o' th' Blackened Spire"
"DOTA_Item_Desc_Kimono_of_the_Ebony_Tower"	"Pilfered from th' many now-dead lord o' th' blackened tower. It always feels so bloody cold.."
"DOTA_Item_Bracers_of_the_Ebony_Tower"	"Guards o' th' Blacken'd Spire"
"DOTA_Item_Desc_Bracers_of_the_Ebony_Tower"	"Pieced t'gether from th' bricks o' th' black spire. Nobody goes thar anymore.."
"DOTA_Item_Relic_Blade_of_the_KuurIshiminari"	"Cap'n Ishiminari's Cutlass o' Jade"
"DOTA_Item_Desc_Relic_Blade_of_the_KuurIshiminari"	"Arr, no one knows where th' cap'n got his sword. It dun cut very well an' it be heavy t' boot, but 'e always seems t' carry it 'round wit' 'im. I saw 'im cut down several privateers durin' an attack, but th' blade ne'er bloodied.."
"DOTA_Item_Kantusa_the_Script_Sword"	"Kantusa th' Character'd Cutlass"
"DOTA_Item_Desc_Kantusa_the_Script_Sword"	"This cutlass be cover'd wit' countless characters in a tongue from a faraway shore. Allegedly, they tell th' tale o' its former owner, whose soul lies sealed within."
"DOTA_Item_Omnishred_the_Defiant"	"Windborne Blade"
"DOTA_Item_Desc_Omnishred_the_Defiant"	"A weapon that feels light as a feather an' cuts th' wind like a finely craft'd vessel conquerin' th' mighty seas."
"DOTA_Item_Healing_Ward_of_the_KuurIshiminari"	"Cap'n Ishiminari's Jade Healin' Trinket"
"DOTA_Item_Desc_Healing_Ward_of_the_KuurIshiminari"	"Th' cap'n wit' th' funny name always carried this 'round 'im. Fo'got how, but 'e took a bullet t' th' face. Could've sworn I saw 'im walkin' 'round th' port wit' a wide smile on 'is face..."
"DOTA_Item_Call_of_the_Dendrochron"	"Stumps o' th' Fallen Ents"
"DOTA_Item_100Proof_Jug"	"300-Proof Jug o' Rum"
"DOTA_Item_Desc_100Proof_Jug"	"Arr, when ye need a bit o' boost of courage t' help ye int' battle an' int' bed. Yaharr!"
"DOTA_Item_Fine_Bone_Bracers"	"Boned Bracers"
"DOTA_Item_Desc_Fine_Bone_Bracers"	"Bracers o' bone. Dun ask us whar we got th' bone. It wat'n't a pretty sight an' we'd feel better if ye stopped askin'."
"DOTA_Item_PreyTrackers_Aspect_Mask"	"Mask o' th' Predator"
"DOTA_Item_Staff_of_the_Eagle"	"Eagle Staff"
"DOTA_Item_Desc_Staff_of_the_Eagle"	"Th' prophet may like green things, but 'e also likes things like birds an' lizards. Sometimes those be green too!"
"DOTA_Item_Blade_of_the_Dark_Ancients"	"Blade o' th' Dark Ancients"
"DOTA_Item_Habit_of_the_Seeker"	"Th' Seekers Bloodied Tunic"
"DOTA_Item_HlotlFeather_Gloves"	"Th' Feather'd Vambraces"
"DOTA_Item_Desc_War_Gloves_of_Sanguine_Glory"	"Th' fashion these days seems t' be \"Stick feathers in ev'rythin. Maybe a few shiny baubles.\" I dun get it, but I look down right strappin' wit' this 'ere feather."
"DOTA_Item_HlotlTusk_Headdress_of_the_Seeker"	"Th' Seeker's Bony Headdress"
"DOTA_Item_HlotlFeather_Necklace"	"Feather'd Necklace"
"DOTA_Item_Desc_HlotlFeather_Necklace"	"Some lads jus' like t' look fancy wit' their feathers."
"DOTA_Item_Wyrm_Helm_of_Uldorak"	"Cap'n Uldorak's Skull"
"DOTA_Item_Desc_Wyrm_Helm_of_Uldorak"	"Thar be rumors o' some kind o' lizard man bein' captain o' some o' th' most ruthless pirates o' th' Dead Sea. Looks like 'e be nothin' more than a fancy helmet now."
"DOTA_Item_Wyrm_Bracer_of_Uldorak"	"Cap'n Uldorak's Bindings"
"DOTA_Item_Desc_Wyrm_Bracer_of_Uldorak"	"Uldorak knew two things: Coin an' weapons. He took no prisoner an' took whatever was valuable 'fore slittin' their throat. Now 'e little more than a bracer of 'is own skin."
"DOTA_Item_Wyrm_Skirt_of_Uldorak"	"Cap'n Uldorak's Skirt"
"DOTA_Item_Desc_WyrmGuard_of_Uldorak"	"Cap'n Uldorak 'ad one thorn in 'is side: Queen Tansis XII o' Dowager. A spiteful relationship wit' th' two always playin' cat n' mouse wit' eachother, always clawin' fer their throats. Guess ol' Queenie got 'er end of th' bargain. Jus' wonder if it was worth it all."
"DOTA_Item_Wyrm_Pauldron_of_Uldorak"	"Cap'n Uldorak's Spaulders"
"DOTA_Item_Desc_Wyrm_Pauldron_of_Uldorak"	"Th' cap'n was known for 'avin' some weird characteristics 'bout 'im. He usually kept 'is face obscured wit' a cowl, but thar be strong rumors of 'im havin' huge horns on 'is head, like some kind o' sea devil. Looks like th' horns be but a simple decoration now."
"DOTA_Item_Gloves_of_the_Admirable_Admiral"	"Th' Admiral's Admirable Gloves"
"DOTA_Item_Desc_Gloves_of_the_Admirable_Admiral"	"Fine white gloves o' silk. British design, double woven. Prestigious an' bloody hard t' get. Arr, this be a sought after piece o' loot. Cap'n usually had dibs though."
"DOTA_Item_Ceremonial_Rapier"	"Ceremonial Rapier"
"DOTA_Item_Desc_Ceremonial_Rapier"	"No idea why th' cap'n carries this thing 'round. It dun even cut very well, but 'e likes t' carry it. Sure 'e kill'd a king's son or two, but at least take somethin' that hurts!"
"DOTA_Item_Sword_of_the_SeventySeven_Seas"	"Sword o' th' Seventy-Seven Seas"
"DOTA_Item_Desc_Sword_of_the_Seventy_Seven_Seas"	"Now this be a weapon t' live by. Finely craft'd silver an' steel, it be a vicious weapon that 'as been pass'd down from cap'n t' cap'n, willingly or not. Yaharr."
"DOTA_Item_Grand_Curls_of_the_Admirable_Admiral"	"Th' Fancy Admiral's Wig"
"DOTA_Item_Desc_Grand_Curls_of_the_Admirable_Admiral"	"This be downright silly. At least 'e could get rid o' th' feather."
"DOTA_Item_Seafarers_Shoes"	"Landlubber Shoes"
"DOTA_Item_Desc_Seafarers_Shoes"	"A pair o' finely crafted leather shoes, complete wit' brass buckles an' rubber soles. For when th' Cap'n dun want t' touch land wit' 'is feet."
"DOTA_Item_BackAche"	"Back-Ache"
"DOTA_Item_Desc_BackAche"	"A strange effect o' scurvy on less than human pirates. Needless t' say it helps ward off foes comin' in fer a stab in th' back."
"DOTA_Item_Excavators_Treasure"	"Shifty Fishy Fish Skull"
"DOTA_Item_Desc_Excavators_Treasure"	"Bloody 'ell, these be some big fish."
"DOTA_Item_Naval_Mine"	"Naval Mine"
"DOTA_Item_Desc_Naval_Mine"	"A device from a long fergotten era, it makes fer a nasty bruise when smacked wit' it!"
"DOTA_Item_Swamp_Fins"	"Swampy Sea Fins"
"DOTA_Item_Pillar_of_Strength"	"Tower o' Power"
"DOTA_Item_Desc_Pillar_of_Strength"	"Why cut down trees when ye can cut down foes and their reinforced fortresses an' bastions wit' a powerful swing an' a blade made o' marble?"
"DOTA_Item_Stone_Loins"	"Stone Skirt"
"DOTA_Item_Desc_Stone_Loins"	"When ye need somethin' t' protect ye, jus' take a rock an' stick it on ye. Probably a terrible idea, but whaddya care, yer drunk!"
"DOTA_Item_Stone_Guard"	"Stone Guard"
"DOTA_Item_Desc_Stone_Guard"	"A few bits o' junk an' some rope an' ye've got yerself some armor! Probably won't stop scurvy though."
"DOTA_Item_Stone_Helmet"	"Horn'd Leather Helmet"
"DOTA_Item_Desc_Stone_Helmet"	"At least it's not a bleedin' rock on yer head."
"DOTA_Item_Bracers_of_the_Radiant_Crusader"	"Armlets o' th' Radiant Pirate"
"DOTA_Item_Hammer_of_the_Radiant_Crusader"	"Blackbeard's Thumb"
"DOTA_Item_Desc_Hammer_of_the_Radiant_Crusader"	"A neat lil' tool 'e kept 'round when 'e didn't need it, but all pirates feared it when 'e gave a mate a thumbs up."
"DOTA_Item_Champion_of_Emauracus"	"Commodore Smiffy's Feathery Skullcap"
"DOTA_Item_Desc_Champion_of_Emauracus"	"Blood be on th' water whene'er ye saw Commodore Smiffy don this 'ere helm. Pirates murmur 'bout it bein' made o' doves used fer a king's burial, but it really jus' be fowl feathers."
"DOTA_Item_Raw_Hide"	"Jaws o' Death"
"DOTA_Item_Desc_Raw_Hide"	"When yer bein' stripp'd t' yer skivvies, impress th' lads wit' this lil' diddy."
"DOTA_Item_Cerebral_Support"	"Shifty Fishy Backbone"
"DOTA_Item_Skeletal_Catch"	"Shifty Fishy Fish Bones"
"DOTA_Item_Femur_Thrasher"	"Shifty Fishy Fat Bone"
"DOTA_Item_Desc_Femur_Thrasher"	"A really big bone from one really fat lookin' fish."
"DOTA_Item_BeastJaw_Bludgeoner"	"Jaw on a Stick"
"DOTA_Item_Desc_BeastJaw_Bludgeoner"	"T' be honest, we dun e'en know who made this. Who takes a bloody jaw an' puts it on a stick?"
"DOTA_Item_Mask_of_the_Freelancer"	"Bloodbrawler's Casque"
"DOTA_Item_Pantaloons_of_the_Freelancer"	"Pantaloons o' th' Freeloader"
"DOTA_Item_Desc_Pantaloons_of_the_Freelancer"	"These fine pantaloons show that Sven be on a tight coin budget o' sorts. No time fer yer best pantaloons when ye got a battle t' fight!"
"DOTA_Item_Sword_of_the_Freelancer"	"Sword o' th' Freeloader"
"DOTA_Item_Dragonmaw"	"Cap'n Davion's Hideshredder"
"DOTA_Item_Pirate_Slayers_Bracer"	"Pirate Slayer's Bracer"
"DOTA_Item_Desc_Pirate_Slayers_Bracer"	"A gigantic bracer made from bits o' sail an' tied wit' line."
"DOTA_Item_Pirate_Slayers_Tricorn"	"Tricorn o' th' Fallen"
"DOTA_Item_Desc_Pirate_Slayers_Tricorn"	"Someone has pilfer'd th' sail o' a fine pirate ship an' crudely sewn it into a mockery o' a pirate's tricorn. 'Tis just shameful!"
"DOTA_Item_Squiddles"	"Squiddles"
"DOTA_Item_Desc_Squiddles"	"This actually be a dead squid I found on th' shore. Now I can't get'im off!"
"DOTA_Item_Sword_of_the_Admirable_Admiral"	"Sword o' th' Admirable Admiral"
"DOTA_Item_Desc_Sword_of_the_Admirable_Admiral"	"Arr, a fine specimen, worthy o' th' Cap'n's first pick o' th' loot. Th' hilt be dress'd in worked gold an' exotic stones, an' th' blade be bless'd wit' a strange, glowin' enchantment."
"DOTA_Item_Executioners_Axe"	"Executioner's Axe"
"DOTA_Item_Desc_Executioners_Axe"	"Th' pirate's bane. Th' metal be stain'd wit' th' blood o' fallen comrades dancin' th' steel-edged jig."
"DOTA_Item_Executioners_Cape"	"Executioner's Cloak"
"DOTA_Item_Desc_Executioners_Cape"	"A menacin' lookin' cloak, dyed black. Smells an awful lot like fish though.."
"DOTA_Item_Executioners_Trophies"	"Executioner's Trophies"
"DOTA_Item_Desc_Executioners_Trophies"	"Avast! I think I see me old matey thar! 'e dun look too well though.."
"DOTA_Item_Executioners_Hood"	"Executioner's Cowl"
"DOTA_Item_Desc_Executioners_Hood"	"Th' cowl o' th' executioner be th' worst thing ye can see. Next t' wakin' up wit' three ugly wenches."
"DOTA_Item_SeaGods_Ceremonial_Headdress"	"Sea-God's Festive Headdress"
"DOTA_Item_Desc_SeaGods_Ceremonial_Headdress"	"Arr, this 'ere loot ain't described or nothin'."
"DOTA_Item_Cold_Case_Bow"	"Th' Shivers"
"DOTA_Item_Desc_Cold_Case_Bow"	"Two magickal frost orbs charge this 'ere bow wit' arcane energy."
"DOTA_Item_Shuriken_of_the_Hidden_Hunter"	"Bone Wheel o' th' Southern Seas"
"DOTA_Item_Desc_Shuriken_of_the_Hidden_Hunter"	"Makes fer a nice toy an' a vicious tool o' death t' cut yer foes wit'."
"DOTA_Item_Harvester_of_the_Hidden_Hunter"	"Th' Cruel Joke"
"DOTA_Item_Desc_Harvester_of_the_Hidden_Hunter"	"Cap'n usually used a curved stick t' keep 'is men in line. He laugh'd when 'e found out th' sharpen'd version made fer bloody spectacles."
"DOTA_Item_Cleaver_of_the_Hidden_Hunter"	"Cap'n Sol's Butcher Knife"
"DOTA_Item_Desc_Cleaver_of_the_Hidden_Hunter"	"Cap'n Sol's legendary cleaver that 'e used t' cut th' heads o' mutinous traitors an' kings alike. They say 'e be th' reason they call it th' Red Sea."
"DOTA_Item_Forgemasters_Apron"	"Blacksmith's Apron"
"DOTA_Item_Desc_Blacksmiths_Apron"	"Scrawl'd upon it in a lost language be th' words, \"Kiss th' axe.\""
"DOTA_Item_Forgemasters_Armlet"	"Blacksmith's Armlet"
"DOTA_Item_Forgemasters_Hammer"	"Blacksmith's Hammer"
"DOTA_Item_Desc_Forgemasters_Hammer"	"Dun let th' clang o' steel fool ye - Makin' a weapon be bloody 'ard work! One time I tried t' make a sword an' ended up wit' a boot. Iunno 'ow I e'en did that!"
"DOTA_Item_Forgemasters_Mask"	"Blacksmith's Mask"
"DOTA_Item_Desc_Forgemasters_Mask"	"Th' Red Mist were damn good smiths. They always 'ad black smoke billowin' from thar smithy's, always craftin' blades o' th' finest calibre. Dun invite them t' drinkin' games though. They be sore losers.."
"DOTA_Item_Ice_Burst_Bow"	"Crystalline Bow"
"DOTA_Item_Desc_Ice_Burst_Bow"	"A mighty brow that bristles with th' crystal ice o' th' North Pole."
"DOTA_Item_The_Cleaver_of_Might"	"Th' Cleaver o' Might"
"DOTA_Item_Natures_Bow"	"Natures Bow"
"DOTA_Item_Chronite_Armor"	"Pauldrons o' th' Void"
"DOTA_Item_Desc_Chronite_Armor"	"Th' strange crystals dun seem t' be much o' much worth, but they definitely look shiny. Though I be havin' th' weirdest cases o' déjà vu.."
"DOTA_Item_Chronite_Bracers"	"Bracers o' th' Void"
"DOTA_Item_Chronite_Scepter"	"Scepter o' th' Void"
"DOTA_Item_Voidkeepers_Visage"	"Ol' Hole in th' Head"
"DOTA_Item_Desc_Voidkeepers_Visage"	"Drunken brawls can lead t' unexpected wounds."
"DOTA_Item_Ice_Burst_Bracers"	"Crystalline Bindings"
"DOTA_Item_Desc_Ice_Burst_Bracers"	"Arr, don't be fooled by th' size o' Drow's bracers. These sharp ice crystals weigh nothin' an' so do not hinder th' Drow Ranger's orbwalkin' (and yer dyin')."
"DOTA_Item_Ice_Burst_Greaves"	"Crystalline Greaves"
"DOTA_Item_Creepers_Cruel_Painsaw"	"Th' Cap'ns Jagged Smile"
"DOTA_Item_Desc_Creepers_Cruel_Painsaw"	"Th' Cap'n ne'er smiled when goin' 'bout 'is business, but if 'e did, ye knew 'e wasn't plannin' somethin' nice."
"DOTA_Item_Creepers_Cruel_Hook"	"Th' Cap'ns Left Hook"
"DOTA_Item_Desc_Creepers_Cruel_Hook"	"Th' Cap'n enjoyed havin' th' upper hand. Sometimes, literally."
"DOTA_Item_Creepers_Cruel_Shuriken"	"Th' Cap'ns Cruel Logic"
"DOTA_Item_Desc_Creepers_Cruel_Shuriken"	"None escape th' viciousness that be th' Cap'n an' 'is ways."
"DOTA_Item_Blademothers_Crawlers"	"Blademother's Crawlers"
"DOTA_Item_Blademothers_Goggles"	"Blademother's Goggles"
"DOTA_Item_Blademothers_Abdomen"	"Blademother's Abdomen"
"DOTA_Item_Spiral_Staff"	"Twist'd Staff o' Sight"
"DOTA_Item_Pincher_Bow"	"Admiral Pinchy's Bow"
"DOTA_Item_Desc_Pincher_Bow"	"Th' bleedin' thing be 'eavy an' be th' favorite o' Admiral Pincetta or 'Pinchy'. She hated that an' shot anyone that called 'er that name. It be how I lost me good eye!"
"DOTA_Item_Dressed_Pauldron_of_the_Mono_Militis"	"Dressed Pauldron o' th' One-Eyed Crew"
"DOTA_Item_Desc_Dressed_Pauldron_of_the_Mono_Militis"	"This 'ere be one o' th' more refined pieces o' armor pilfer'd from th' One-Eyed Crew crew. Bastards put up a fight we won't ferget. We only saw two o' these, one o' 'em on th' man that murder'd me Cap'n. We got our revenge, though - they get call'd th' No-Eye Crew nowadays."
"DOTA_Item_Cyclopean_Helm_of_the_Mono_Militis"	"Cyclopean Helm o' th' One-Eyed Crew"
"DOTA_Item_Desc_Cyclopean_Helm_of_the_Mono_Militis"	"A helm o' th' One-Eyed Crew. Havin' lost eyes an other body parts throughout their honest piratin' careers, this fabled crew turned t' a magick woman livin' deep in th' murky swamps o' th' east. She granted them a cats-eye gemstone, allowin' them t' use magick t' compensate fer their lack o' vision."
"DOTA_Item_Sword_of_the_Mono_Militis"	"Sword o' th' One-Eyed Crew"
"DOTA_Item_Desc_Sword_of_the_Mono_Militis"	"The One-Eyed Crew were a fearsome lot, havin' dabbled all too often in deep magick. I 'erd their swords be enchant'd t' addle th' mind an' sap th' strength o' their victims."
"DOTA_Item_Sword_of_the_Flameguard"	"Sword o' th' Flameguard"
"DOTA_Item_Desc_Sword_of_the_Flameguard"	"A heavily weight'd sword craft'd in th' two-handed style o' th' Flameguard Fleet."
"DOTA_Item_Pirate_Slayers_Cutlass"	"Pirate Slayer's Cutlass"
"DOTA_Item_Desc_Pirate_Slayers_Cutlass"	"Sometimes life at sea boils down t' showin' who be in charge. Th' skull attached t' this blade (formerly belongin' t' an unfortunate cap'n) aims t' do just that."
"DOTA_Item_Pirate_Slayers_Black_Flag"	"Pirate Slayer's Black Flag"
"DOTA_Item_Desc_Pirate_Slayers_Black_Flag"	"Th' marque o' a formerly fearless crew, this flag acts now as a symbol o' th' Tidehunter's power."
"DOTA_Item_Desc_ShovelMouthed_Mask"	"Juggernaut would never shut his great mouth 'till th' gods above made this mask fer his facehole. Arr, 'tis much quieter on th' battlefield now."
"DOTA_Item_War_Blade_Right"	"Blood Guzzler's Right-Hand Blade o' War"
"DOTA_Item_Desc_War_Blade_Right"	"An exceptionally sharp war-blade. Stand well back!"
"DOTA_Item_War_Blade_Left"	"Blood Guzzler's Left-Hand Blade o' War"
"DOTA_Item_Desc_War_Blade_Left"	"An exceptionally sharp war-blade. Stand well back!"
"DOTA_Item_Headcrusher"	"Crusher o' Heads"
"DOTA_Item_Helm_of_the_Flameguard"	"Helm o' th' Flameguard"
"DOTA_Item_Desc_Helm_of_the_Flameguard"	"Th' Flameguard Fleet reckon their duty is t' protect th' ever-burnin' Holy Flame. Codswallop, if ye ask me! Either way, they take it seriously, trainin' t' have some o' th' finest swordsmanship in th' southern seas."
"DOTA_Item_Dressed_Pauldron_of_the_Flameguard"	"Dress'd Pauldron o' th' Flameguard"
"DOTA_Item_Desc_Dressed_Pauldron_of_the_Flameguard"	"Th' armor o' th' Flameguard Fleet be functional an' fancy. From their lookouts 'midst th' Inner Colonnade, th' Flameguard keep watch o' th' Holy Flame."
"DOTA_Item_Cape_of_the_Flameguard"	"Cape o' th' Flameguard"
"DOTA_Item_Desc_Cape_of_the_Flameguard"	"Th' Flameguard wear capes as blue as th' Holy Flame they be sworn t' protect. Th' back contains some sort o' symbol representin' th' Inner Colannade an' th' Flame itself. Bonkers, th' lot o' 'em - I ain't never seen a self-respectin' pirate wearin' a cape!"
"DOTA_Item_Skirt_of_the_Flameguard"	"Skirt o' th' Flameguard"
"DOTA_Item_Desc_Skirt_of_the_Flameguard"	"Arrr, say what ye like about them, but ye gotta admire their devotion t' Th' Flame. I feel th' same way about coin."
"DOTA_Item_Commanders_Helm_of_the_Flameguard"	"Cap'n's Helm o' th' Flameguard"
"DOTA_Item_Desc_Commanders_Helm_of_the_Flameguard"	"Th' Flameguard Fleet be few in number, but their legendary leadership more than makes up fer that."
"DOTA_Item_Commanders_Gauntlet_of_the_Flameguard"	"Cap'n's Gauntlet o' th' Flameguard"
"DOTA_Item_Desc_Commanders_Gauntlet_of_the_Flameguard"	"An armor'd gauntlet o' th' Flameguard Fleet, worn t' make th' Cap'n stand out on deck."
"DOTA_Item_Lucky_Alpine_Stalkers_Hat"	"Lucky Alpine/Cowboy's Hat"
"DOTA_Item_Desc_Lucky_Alpine_Hat"	"Th' bane o' all o' th' Dota community."
"DOTA_Item_Alpine_Stalkers_Scarf"	"Alpine/Cowboy Stalker's Scarf"
"DOTA_Item_Alpine_Stalkers_Pants"	"Alpine/Cowboy Stalker's Pantaloons"
"DOTA_Item_Alpine_Stalkers_Gloves"	"Alpine/Cowboy Stalker's Gloves"
"DOTA_Item_Back_Hook_Right"	"Back Hook"
"DOTA_Item_Desc_Back_Hook_Right"	"Yaharr, now that be one bastard of a hook! Cannah get one fer me an' me mateys?"
"DOTA_Item_Back_Hook_Left"	"Back Hook (Left)"
"DOTA_Item_Desc_Back_Hook_Left"	"Yaharr, now that be one bastard of a hook! Cannah get one fer me an' me mateys?"
"DOTA_Item_Witch_Doctors_Vile_Hat"	"Witch Doctor's Vile Hat"
"DOTA_Item_Desc_Witch_Doctors_Vile_Hat"	"Arr, this 'ere loot ain't described or nothin'."
"DOTA_Item_Witch_Doctors_Dreaded_Dreads"	"Witch Doctor's Dreaded Dreads"
"DOTA_Item_Juju_o_Wicked_Badness"	"Juju o' Wick'd Badness"
"DOTA_Item_Desc_Juju_o_Wicked_Badness"	"A vicious lil' soul-trap wit' a skull t' show that it be workin'."
"DOTA_Item_Staff_o_Wicked_Badness"	"Staff o' Wick'd Badness"
"DOTA_Item_Mask_o_Wicked_Badness"	"Mask o' Wick'd Badness"
"DOTA_Item_Desc_Skull_Mask_o_Wicked_Badness"	"A great an' mighty voodoo mask o' wickedness. Fer that special someone on th' battlefield."
"DOTA_Item_Witch_Doctors_Shrunken_Head_Staff"	"Witch Doctor's Shrunken Head Staff"
"DOTA_Item_Flower_Staff_of_the_PeaceBringer"	"Hermit's Really Big Flower"
"DOTA_Item_Desc_Flower_Staff_of_the_PeaceBringer"	"A really big flower th' hermit pick'd when strollin' through th' Endless Copse."
"DOTA_Item_Lei_of_the_PeaceBringer"	"Lei o' th' Hermit"
"DOTA_Item_Desc_Lei_of_the_PeaceBringer"	"Apparently this be some kind o' necklace worn at festivities that be meanin' friendship an' all that rot. They dun e'en smell good!"
"DOTA_Item_Horns_of_the_PeaceBringer"	"Horns o' th' Hermit"
"DOTA_Item_Desc_Horns_of_the_PeaceBringer"	"Horns bent int' some archaic an' silly symbol. I think it means 'lunch'."
"DOTA_Item_Beard_of_the_PeaceBringer"	"Beard o' th' Hermit"
"DOTA_Item_Desc_Beard_of_the_PeaceBringer"	"Scraggly an' wirey."
"DOTA_Item_Pangolin_Carapace"	"Pangolin Shell"
"DOTA_Item_Desc_Pangolin_Carapace"	"Dunno 'ow someone figured this out, but it bloody well useful 'gainst a horde an' yer down t' yer skivvies."
"DOTA_Item_Pangolin_Scarf"	"Pangolin Hunter's Mark"
"DOTA_Item_Desc_Pangolin_Scarf"	"A bleedin' bright-lookin' bandana worn on yer face t' appear as some kind o' master hunter or somethin'. Jus' makes ye look like ye love bananas."
"DOTA_Item_Frost_Spikes"	"Frost Spikes"
"DOTA_Item_Desc_Frost_Spikes"	"A piratey bit o' hair that says \"Arr, ye got five grains o' sand t' stop starin' at me head before ye've no eyes fer lookin'.\" Most foes don't finish lookin' in time."
"DOTA_Item_Cape_of_the_Burning_Cabal"	"Cape o' th' Red Cabal"
"DOTA_Item_Desc_Cape_of_the_Burning_Cabal"	"Th' Red Cabal really like th' color red an' anythin' wit' red in it, tellin' ev'ryone 'ow red be th' best color."
"DOTA_Item_Bracer_of_the_Burning_Cabal"	"Wraps o' th' Red Cabal"
"DOTA_Item_Desc_Bracer_of_the_Burning_Cabal"	"Oddly 'nuff, they're actually made o' silk, embroidered in velvet, but they be warm t' th' touch. Th' Red Cabal typically flash'd these in public when they be preachin'."
"DOTA_Item_Crest_of_the_Burning_Cabal"	"Crest o' th' Red Cabal"
"DOTA_Item_Desc_Crest_of_the_Burning_Cabal"	"Th' crest o' th' Red Cabal. Only th' brave an' foolish be wearin' this in public after th' last assassination attempt on one o' th' lord's daughters."
"DOTA_Item_Commanders_Pauldron_of_the_Flameguard"	"Cap'n's Pauldron o' th' Flameguard"
"DOTA_Item_Desc_Lords_Pauldron_of_the_Flameguard"	"Th' armor o' th' Flameguard Fleet be functional an' fancy. From their lookouts 'midst th' Inner Colonnade, th' Flameguard keep watch o' th' Holy Flame. This particular bit o' armor were craft'd fer a cap'n."
"DOTA_Item_Commanders_Cape_of_the_Flameguard"	"Cap'n's Cape o' th' Flameguard"
"DOTA_Item_Desc_Commanders_Cape_of_the_Flameguard"	"Th' Flameguard wear capes as blue as th' Holy Flame they be sworn t' protect. Th' back contains some sort o' symbol representin' th' Inner Colannade an' th' Flame itself. This particular cape were craft'd fer a cap'n. Bonkers, th' lot o' 'em - I ain't never seen a self-respectin' pirate wearin' a cape!"
"DOTA_Item_Commanders_Skirt_of_the_Flameguard"	"Cap'n's Skirt o' th' Flameguard"
"DOTA_Item_Desc_Commanders_Skirt_of_the_Flameguard"	"Arrr, say what ye like about them, but ye gotta admire their devotion t' Th' Flame. I feel th' same way about coin. Anyway, this particular piece were 'specially craft'd fer a cap'n."
"DOTA_Item_Witch_Doctors_Demon_Skull_Staff"	"Witch Doctor's Demon Skull Staff"
"DOTA_Trial_UpgradeItem"	"Dota 2 Trial Upgrade Booty"
"DOTA_Item_Baggin_This"	"Baggin' This"
"DOTA_VoiceTaunt_InTheBag_Desc"	"Show jus' how much confidence ye share fer th' enemy crew. What could possibly go wrong?"
"DOTA_Custom_Courier_Sheep"	"Sheep Courier"
"DOTA_Custom_Courier_Sheep_Desc"	"Baa."
"DOTA_Custom_Courier_ShittyWizard"	"Shitty Wizard"
"DOTA_Custom_Courier_ShittyWizard_Desc"	" "
"DOTA_Custom_Courier_MiniPudge"	"Minipudge Courier"
"DOTA_Custom_Courier_MiniPudge_Desc"	"Bloody 'ell, you're small."
"DOTA_Item_Announcer_Dr_Kleiner"	"Announcer: Dr. Kleiner"
"DOTA_Item_Enduring_War_Dog"	"Endurin' War Dog"
"DOTA_Item_Desc_Juggernaut_Dog_Courier"	"A beast that 'as been trained t' follow its master int' battle an' back, witnessin' th' horrors an' glory that battle be filled wit'. No soul will e'er know what it be truly thinkin' beneath that mask o' birch."
"DOTA_Item_Snowleopard_Courier"	"Snowleopard Courier"
"DOTA_Item_Desc_Copy_of_Minipudge_Courier"	"Bloody 'ell, you're small."
"DOTA_Item_Trusty_Mountain_Yak"	"A Yak wit' a Mask"
"DOTA_Item_Desc_Juggernaut_Yak_Courier"	"A long time ago, in th' early days o' th' ancient defense, Yurnero, by sheer chance, slipped one o' his masks ont' a courier by mistake. Now he spends his days fightin' t' earn enough gold t' surgically remove th' mask."
"DOTA_Item_Fearless_Badger"	"Fearful Badger"
"DOTA_Item_Desc_Badger_Courier"	"Arr, th' badger 'tis a fast one. Makes fer perfect shootin' practice!"
"DOTA_Item_Announcer_Juggernaut"	"Announcer: Juggernaut"
"DOTA_Item_MegaKills_Juggernaut"	"Mega-Murders: Juggernaut"
"DOTA_Item_Announcer_Natures_Prophet"	"Announcer: Nature's Prophet"
"DOTA_Item_MegaKills_Natures_Prophet"	"Mega-Murders: Nature's Prophet"
"DOTA_Item_Stumpy__Natures_Attendant"	"Ol' Barkbeard"
"DOTA_Item_Desc_Stumpy_the_Hearty"	"Ol' Barkbeard was never cut out fer battle, but he's always happy t' guard yer loot and haul it around. A fine example t' the crew."
"DOTA_Item_Lost_Treasure_of_the_Ivory_Isles"	"Ivory Chest o' th' Isles"
"DOTA_Item_Desc_Treasure_Chest"	"Ye need a <font color='#9da1a9'>Treasure Key</font> t' open this chest. Ye can get one at th' DOTA 2 Market. Remember, each chest series has a different sort o' loot in it, so choose yer unlocks wisely!"
"DOTA_Item_Treasure_of_the_Deep_Druids"	"Treasure o' th' Deep Druids"
"DOTA_Item_Treasure_Chest"	" "
"DOTA_TreasureChest_Rare"	" "
"DOTA_TreasureChest_Desc"	" "
"DOTA_Item_Desc_Tickled_Tegu"	"A friendly lookin' Tegu from th' giant squid infested Cathauran Wastes. He be smilin' like 'e knows where yer rum be!"
"DOTA_Item_Mighty_Boar"	"Mediocre Boar"
"DOTA_Item_Desc_Mighty_Boar"	"'Tis but a boar. It ain't angry or hungry. Nothin' more."
"DOTA_Item_Moroks_Mechanical_Mediary"	"Morok's Mechanical Mechanism"
"DOTA_Item_Desc_Moroks_Mechanical_Mediary"	"Don't let its metal form deceive yer eye: this contraption be more magick than machine. 'Twas fashion'd by th' Mad Mage Morok, who was far too lazy t' carry his own spell books an' far too cheap t' hire a crew. I can understand were he be comin' from!"
"DOTA_Item_Name_Tag"	"Title Tag"
"DOTA_Item_Desc_Tag"	"Describin' Scroll"
"DOTA_Item_Backpack_Expander"	"Backpack Expander"
"DOTA_Item_Desc_Backpack_Expander"	"Use this 'ere tool t' add space fer 128 pieces o' loot in yer Treasure Chest. Take note: ye can use an expander once and once only."
"DOTA_Item_Treasure_Key"	"Treasure Key"
"DOTA_Item_Desc_75_Battle_Bonus_3_Days"	"Use this 'ere bit o' loot t' bolster th' rate at which ye acquire <font color='#9da1a9'>Battle Tallies</font> by <font color='#9da1a9'>75%</font> fer 3 days. Further, ye'll grant other scallywags a stackin' <font color='#9da1a9'>15%</font> bonus t' their <font color='#9da1a9'>Battle Talllies</font> rate."
"DOTA_Item_Desc_75_Battle_Bonus_6_Days"	"Use this 'ere bit o' loot t' bolster th' rate at which ye acquire <font color='#9da1a9'>Battle Tallies</font> by <font color='#9da1a9'>75%</font> fer 6 days. Further, ye'll grant other scallywags a stackin' <font color='#9da1a9'>15%</font> bonus t' their <font color='#9da1a9'>Battle Talllies</font> rate."
"DOTA_Item_Gift_RandomPerson"	"Shopkeeper's Surprise"
"DOTA_Item_Gift_EntireGame"	"Legendary Largesse"
"DOTA_Item_Gift_Tons"	"Breathtakin' Benefaction"
"DOTA_Item_Strange_Essence_Carries_Killed"	"Strange Essence: Carries Kill'd"
"DOTA_Item_LeagueViewPass"	" League View Test"
"DOTA_Item_Desc_LeagueViewPass"	" League View Test"
"DOTA_Item_Wicked_Bad_Voodoo_Pack"	"Wick'd Bad Voodoo Pack"
"DOTA_Item_Of_Ebony_and_Ivory_Set"	"Legacy o' th' Isles"
"DOTA_Bundle_Desc_Juggernaut_Ivory_Ebony"	"Arr, 'as all th' loot ye need t' craft yer own 'Legacy o' th' Isles' set fer Juggernaut:"
"DOTA_Item_Wicked_Bad_Voodoo_Set"	"Wick'd Bad Voodoo Set"
"DOTA_Bundle_Desc_Witch_Doctor_Wicked_Bad_Voodoo"	"Arr, 'as all th' loot needed t' make yer own 'Wick'd Bad Voodoo' set fer Witch Doctor:"
"DOTA_Item_Forged_in_Demons_Blood_Set"	"Craft'd in Demons' Blood Set"
"DOTA_Bundle_Desc_Axe_Demon_Blood"	"Arr, 'as all th' loot needed t' make yer own 'Crafted in Demons Blood' set fer Axe:"
"DOTA_Item_The_Defiant_Axe_Set"	"Th' Defiant Axe Set"
"DOTA_Bundle_Desc_Axe_Defiant"	"Arr, 'as all th' loot needed t' craft 'Th' Defiant Axe' set fer Axe:"
"DOTA_Item_Traveler_on_the_High_Plains_Set"	"High Plains Hunter Set"
"DOTA_Bundle_Desc_Juggernaut_High_Plains"	"Arr, 'as all th' loot ye need t' craft yer own 'High Plains Hunter' set fer Juggernaut:"
"DOTA_Item_Scion_of_the_Savage_Set"	"Scion o' th' Savage Set"
"DOTA_Bundle_Desc_Natures_Prophet_Scion_Savage"	"Arr, 'as all th' loot t' make yer own 'Scion of the Savage' set fer Nature's Prophet:"
"DOTA_Bundle_Natures_Prophet_Peace_Bringer"	"Garments o' th' Hermit Set"
"DOTA_Bundle_Desc_Natures_Prophet_Peace_Bringer"	"Arr, 'as all th' loot ye need t' make yer own 'Garments o' th' Hermit' set fer Nature's Prophet:"
"DOTA_Bundle_Axe_Berserker"	"Th' Bloody Berserker Set"
"DOTA_Bundle_Desc_Axe_Berserker"	"Arr, 'as all th' loot needed t' make yer own 'Bloody Berserker' set fer Axe:"
"DOTA_Bundle_Axe_Forgemaster"	"Tools o' th' Blacksmith Set"
"DOTA_Bundle_Desc_Axe_Forgemaster"	"Arr, 'as all th' loot needed t' craft yer own 'Tools o' th' Blacksmith' set fer Axe:"
"DOTA_Bundle_Axe_Axecutioner"	"Th' Axecutioner Set"
"DOTA_Bundle_Desc_Axe_Axecutioner"	"Arr, 'as all th' loot needed t' craft 'Th' Axecutioner' set fer Axe:"
"DOTA_Bundle_Sven_Mono_Militis"	"One-Eyed Crew Set"
"DOTA_Bundle_Desc_Sven_Mono_Militis"	"Arr, 'as all th' loot needed t' craft th' \"Armor o' th' One-Eyed Crew\" set fer Sven:"
"DOTA_Bundle_Sven_Flameguard"	"Flameguard Fleet Set"
"DOTA_Bundle_Desc_Sven_Flameguard"	"Arr, 'as all th' loot needed t' craft th' 'Sect Armor o' th' Flameguard' set fer Sven:"
"DOTA_Item_Direstone_Bindings_Set"	"Th' Alpine Stalker's Set"
"DOTA_Item_Desc_Direstone_Bindings_Set"	"Arr, 'as all th' loot needed t' craft 'Th' Alpine Stalker' set fer Ursa:"
"DOTA_Item_Ritual_Garb_of_the_Seeker_Set"	"Ritual Garb o' th' Seeker Set"
"DOTA_Bundle_Desc_Blood_Seeker_Hlotl"	"Arr, 'as all th' loot needed t' craft th' 'Ritual Garb o' th' Seeker' set fer Bloodseeker:"
"DOTA_Item_The_Pirates_Booty_Set"	"Th' Pirate's Booty Set"
"DOTA_Bundle_Desc_Tidehunter_Pirate_Slayer"	"Arr, 'as all th' loot needed t' craft 'Th' Pirate's Booty' set fer Tidehunter:"
"DOTA_Item_The_Admirable_Admiral_Set"	"Th' Admirable Admiral Set"
"DOTA_Item_Uldoraks_Hide_Set"	"Fall o' Cap'n Uldorak Set"
"DOTA_Bundle_Desc_Dragon_Knight_Uldorak"	"Arr, 'as all th' loot t' craft yer own 'Fall o' Cap'n Uldorak' set fer Dragon Knight:"
"DOTA_Bundle_DOTA2_Access"	"Dota 2 Invite"
"DOTA_Item_Spikes_of_Frost_Set"	"Spikes o' Frost Set"
"DOTA_Bundle_Desc_Drow_Ranger_Spikes_Frost"	"Has all o' th' loot in th' 'Spikes o' Frost' set fer Drow Ranger:"
"DOTA_Item_Trappings_of_the_Pangolin_Guild_Set"	"Trappin's o' th' Pangolin Guild Set"
"DOTA_Bundle_Desc_Bounty_Hunter_Pangolin"	"Arr, 'as all th' loot needed t' make yer own 'Trappin's o' th' Pangolin Guild' set fer Bounty Hunter:"
"DOTA_Item_WildCardsWest"	"Wild Waves West"
"DOTA_Item_Desc_WildCardsWest"	"See eight o' th' finest Dota 2 crews clash fer a place in Th' International"
"DOTA_Item_WildCardsEast"	"Wild Waves East"
"DOTA_Item_Desc_WildCardsEast"	"See eight o' th' finest Dota 2 crews clash fer a place in Th' International"
"DOTA_Item_International_2012_Ticket"	"International 2012 Ticket"
"DOTA_WearableType_Shoulder_Pads"	"Shoulder Pads"
"DOTA_WearableType_All_Hero_Taunt"	"All Admiral Mock"
"DOTA_WearableType_Strange_Modifier"	"Strange Modifier"
"DOTA_WearableType_TournamentTicket"	"Tourney Ticket"
"DOTA_Item_Phantom_Assassins_Helmet"	"Phantom Assassin's Helmet"
"DOTA_Item_Phantom_Assassins_Shoulder_Pads"	"Phantom Assassin's Shoulder Pads"
"DOTA_Item_Desc_Copy_of_Phantom_Assassins_Helmet"	"Arr, this 'ere loot ain't described or nothin'."
"DOTA_Item_Phantom_Assassins_Cape"	"Phantom Assassin's Cape"
"DOTA_Item_Desc_Copy_of_Phantom_Assassins_Shoulder_Pads"	"Arr, this 'ere loot ain't described or nothin'."
"DOTA_Item_Phantom_Assassins_Weapon"	"Phantom Assassin's Weapon"
"DOTA_Item_Desc_Copy_of_Phantom_Assassins_Cape"	"Arr, this 'ere loot ain't described or nothin'."
"DOTA_Item_Phantom_Assassins_Daggers"	"Phantom Assassin's Daggers"
"DOTA_Item_Horn_Mask"	"Horn Mask"
"DOTA_Item_Ol_Snaggletooth"	"Lil' Crocky"
"DOTA_Item_Grandfathers_Ribs"	"Old Man's Ribs"
"DOTA_Item_Desc_Grandfathers_Ribs"	"Arr, th' old man were a powerful shaman that carried a crooked smile wit' 'im wherever 'e went, 'avin friends in dark places. Th' old man offered me 'is power on one condition: That 'e see bloody conflict consume th' world once more."
"DOTA_Item_Rattlebite"	"Rattlebite"
"DOTA_Item_Desc_Rattlebite"	"Ghosts be afraid o' snakes too, lad."
"DOTA_Item_Vile_Carnival_Hat"	"Silly Festive Cap"
"DOTA_Item_Shrunken_Head_Staff"	"Shrunken Head Staff"
"DOTA_Item_Desc_Shrunken_Head_Staff"	"Some ugly bugger be hangin' from this 'ere staff. Oh! Pardon me, lad, but that appears t' be yer mum! Haharr!"
"DOTA_Item_Wooden_Fetish_Mask"	"A Piece o' Driftwood"
"DOTA_Item_Desc_Wooden_Fetish_Mask"	"It's tryin' t' smile."
"DOTA_Item_Tribal_Totem_Mask"	"Swamp Beast Mask"
"DOTA_Item_Demon_Skull_Staff"	"Demon Skull Staff"
"DOTA_Item_Desc_Demon_Skull_Staff"	"Witch Doctor clearly 'as somethin' fer skulls. Well, an' paint."
"DOTA_Item_Staff_of_the_Old_Doctor"	"Staff o' th' Old Doctor"
"DOTA_Item_Taunt_Its_in_the_Bag"	"Mock: It's in th' Bag"
"DOTA_Item_Speed_Demon"	"Hasty Demon"
"DOTA_Item_Desc_Speed_Demon"	"He's hot an' heavy an' rarin' t' go. Unless he dies. Then 'e ain't rarin' t' go anywhere but in th' dirt."
"DOTA_Item_Skip_the_Delivery_Frog"	"Skips th' Pondless Frog"
"DOTA_Item_Strange_Modifier_Godlikes"	"Strange Modifier: Godlike"
"DOTA_Item_Desc_Strange_Modifier_Godlikes"	"Addin' this 'ere Strange Modifier t' a strange piece o' loot will make it track th' number o' godlike killin' sprees ye go on while donnin' it."
"DOTA_Item_League_TheDefense_Admin"	"Th' Defense Admin"
"DOTA_Item_League_TheDefense"	"Th' Defense"
"DOTA_Item_Strange_Modifier_First_Blood"	"Strange Modifier: First Blood"
"DOTA_Item_Desc_Strange_Modifier_First_Blood"	"Addin' this 'ere Strange Modifier t' a strange piece o' loot will make it track th' number o' first bloods ye get while wearin' it."
"DOTA_Item_Strange_Modifier_Wards_Placed"	"Strange Modifier: Wards Placed"
"DOTA_Item_Desc_Strange_Modifier_Wards_Placed"	"Addin' this 'ere Strange Modifier t' a strange piece o' loot will make it track th' number o' wards ye put down while wearin' it."
"DOTA_Item_Strange_Modifier_Gold_Earned"	"Strange Modifier: Coin Earned"
"DOTA_Item_Desc_Strange_Modifier_Gold_Earned"	"Addin' this 'ere Strange Modifier t' a strange piece o' loot will make it track th' amount o' coin ye earth while donnin' it. Th' coin earn'd will update at th' end o' a battle."
"DOTA_Item_Strange_Modifier_Gold_Spent"	"Strange Modifier: Coin Spent"
"DOTA_Item_Desc_Strange_Modifier_Gold_Spent"	"Addin' this 'ere Strange Modifier t' a strange piece o' loot will make it track th' amount o' coin ye spend while donnin' it. Th' coin spent stat will update at th' end o' a battle."
"DOTA_Item_Strange_Modifier_Towers_Destroyed"	"Strange Modifier:  Crow's Nests Destroy'd"
"DOTA_WearableType_mount"	"Mount"
"DOTA_Item_Disruptors_Weapon"	"Disruptor's Weapon"
"DOTA_Item_Disruptors_Bracers"	"Disruptor's Bracers"
"DOTA_Item_Desc_Copy_of_Disruptors_Weapon"	"Arr, this 'ere loot ain't described or nothin'."
"DOTA_Item_Disruptors_Hair"	"Disruptor's Hair"
"DOTA_Item_Desc_Copy_of_Disruptors_Bracers"	"Arr, this 'ere loot ain't described or nothin'."
"DOTA_Item_Disruptors_Back"	"Disruptor's Back"
"DOTA_Item_Desc_Copy_of_Disruptors_Hair"	"Arr, this 'ere loot ain't described or nothin'."
"DOTA_Item_Disruptors_Shoulder_Armor"	"Disruptor's Shoulder Armor"
"DOTA_Item_Desc_Copy_of_Disruptors_Back"	"Arr, this 'ere loot ain't described or nothin'."
"DOTA_Item_Disruptors_Mount"	"Disruptor's Mount"
"DOTA_Item_Desc_Copy_of_Disruptors_Shoulder_Armor"	"Arr, this 'ere loot ain't described or nothin'."
"DOTA_Item_Quenn_of_Pains_Ripper_Dagger"	"Queen o' Pain's Ripper Dagger"
"DOTA_Item_Wings_of_Davion_Helmet"	"Cap'n Davion's Skullcap"
"DOTA_Item_Wings_of_Davion_Shield"	"Cap'n Davion's Bulwark"
"DOTA_Item_Bindings_of_the_Rift"	"Fancy Blindfold"
"DOTA_Item_Rune_Hammer"	"Meat Basher"
"DOTA_Item_Hardened_Hunters_Bracer"	"Reinforced Leather Bracer"
"DOTA_Item_Hardened_Hunters_Shoulder_Armor"	"Reinforced Leather Pauldrons"
"DOTA_Item_Hardened_Hunters_Mask"	"Reinforced Leather Mask"
"DOTA_Item_Desc_Strange_Modifier_Towers_Destroyed"	"Addin' this 'ere Strange Modifier t' a strange piece o' loot will make it track th' number o' crow's nests ye wreck while donnin' it."
"DOTA_Item_Unusual_Paint"	"Unusual Lookin' Paint"
"DOTA_Item_Unusual_Paint_Blue"	"Unusual Lookin' Paint: Blue"
"DOTA_Item_Unusual_Paint_Purple"	"Unusual Lookin' Paint: Purple"
"DOTA_Item_Unusual_Paint_Green"	"Unusual Lookin' Paint: Green"
"DOTA_Item_Unusual_Paint_Light_Green"	"Unusual Lookin' Paint: Light Green"
"DOTA_Item_Unusual_Paint_Gold"	"Unusual Lookin' Paint: Gold"
"DOTA_Item_Unusual_Paint_Orange"	"Unusual Lookin' Paint: Orange"
"DOTA_Item_Unusual_Paint_Red"	"Unusual Lookin' Paint: Red"
"DOTA_Bundle_Collection_of_Couriers_Pack"	"Box o' Couriers Pack"
"DOTA_Bundle_Desc_Collection_of_Couriers_Pack"	"Look inside an' maybe ye'll find a cuddly lil' bugger like:"
"DOTA_Bundle_Assemblage_of_Announcers_Pack"	"Box o' Odd Warhorns"
"DOTA_Bundle_Desc_Assemblage_of_Announcers_Pack"	"Ye'll find some odd lookin' horns that say diff'rent things in diff'rent tongues, like:"
"DOTA_WearableType_Skirt"	"Skirt"
"DOTA_WearableType_Twinblade"	"Twinblade"
"DOTA_WearableType_Spear"	"Spear"
"DOTA_WearableType_Tusk"	"Tusk"
"DOTA_WearableType_Drum"	"Drum"
"DOTA_WearableType_Mantle"	"Mantle"
"DOTA_WearableType_Fish_Club"	"Fish Stick"
"DOTA_WearableType_Wheel"	"Wheel"
"DOTA_Item_Skeleton_Kings_head"	"Skeleton King's Head"
"DOTA_Item_Skeleton_Kings_Weapon"	"Skeleton King's Weapon"
"DOTA_Item_Skeleton_Kings_Shoulder"	"Skeleton King's Shoulder"
"DOTA_Item_Skeleton_Kings_Gauntlet"	"Skeleton King's Gauntlet"
"DOTA_Item_Skeleton_Kings_Cape"	"Skeleton King's Cape"
"DOTA_Item_Light_Cape_of_Sir_Davion"	"Cap'n Davion's Tattered Mantle"
"DOTA_Item_Desc_Light_Cape_of_Sir_Davion"	"Let's not fool ourselves 'ere, Cap'n Davion didn't rely on 'is heart, but 'is bleedin' sword an' shield."
"DOTA_Item_SlayerSword_of_Sir_Davion"	"Cap'n Davion's Dragonbane Sword"
"DOTA_Item_Pauldron_of_Sir_Davion"	"Cap'n Davion's Faith"
"DOTA_Item_Desc_Pauldron_of_Sir_Davion"	"A dragon knight be needin' some proper armor if they want t' stop a dragon. Cap'n Davion proved that."
"DOTA_Item_Bracer_of_Sir_Davion"	"Cap'n Davion's Bracer"
"DOTA_Item_Dragonbone_Helm_of_Sir_Davion"	"Cap'n Davion's Dragonbane Helm"
"DOTA_Item_Desc_Dragonbone_Helm_of_Sir_Davion"	"Cap'n Davion 'ad few scars on 'im. Mostly 'cause a dragon's claw can cut down e'en th' mightiest warriors."
"DOTA_Item_Enameled_Shield_of_Sir_Davion"	"Cap'n Davion's Bulwark"
"DOTA_Item_Desc_Enameled_Shield_of_Sir_Davion"	"Sometimes a shield be more important than a sword or a gun. 'Specially 'gainst a dragon. Bastards always swing first."
"DOTA_Item_Twinblade_of_the_Veil"	"Sister's Dualblade"
"DOTA_Item_Desc_Twinblade_of_the_Veil"	"Few pirates 'ad somethin' similar t' this. Jus' take some hemp, two swords, an' ye got a double sword! T'is a shame th' lads never figured out 'ow t' use 'em right."
"DOTA_Item_Desc_Rune_Hammer"	"A well-made hammer, inscribed wit' th' whisper'd words o' th' Dead Prophet an' bolster'd wit' th' magick o' Old One-Eye."
"DOTA_Item_Desc_Hardened_Hunters_Bracer"	"Many folk think that some specialized pirates dun care when they take a life or hurt someone. That's jus' plain rude! We're jus' too drunk t' care."
"DOTA_Item_Hardened_Hunters_Armor"	"Reinforced Leather Pauldrons"
"DOTA_Item_Desc_Hardened_Hunters_Armor"	"Arr, sometimes a life taken ain't worth it's weight in th' coin ye pilfer."
"DOTA_Item_Desc_Hardened_Hunters_Mask"	"In this 'ere line o' work,  ye ain't got mates. Jus' drunks that dun flap their lips when ye do somethin' stupid."
"DOTA_Item_Manifold_Spear"	"Poseidon's Wrath"
"DOTA_Item_Desc_Manifold_Spear"	"A spear wit' three blades. Some mates claim it t' be a form o' Poseidon's legendary trident, but it bloody well 'urts like a spear!"
"DOTA_Item_Kingslayer_Axe"	"Kingslayer Axe"
"DOTA_Item_Desc_Kingslayer_Axe"	"An axe carefully molded and craft'd fer one purpose. Each edge representin' th' four rulin' lords."
"DOTA_Item_Edgebearers_Helm"	"Edgebearer's Helm"
"DOTA_Item_Desc_Edgebearers_Helm"	"Th' true terror o' th' deep."
"DOTA_Item_Hammer_of_Holy_Words"	"Hammer o' Holy Words"
"DOTA_Item_Death_Mask_of_the_Brave"	"Death Mask o' th' Brave"
"DOTA_Item_Desc_Death_Mask_of_the_Brave"	"Look at th' beast in th' eyes an' ye'll see death. Lookit me eyes an' ye'll only see a drunk bastard who knew 'ow t' swing a sword, haharr!"
"DOTA_Item_Elder_Tusk_of_the_Brave"	"Elder Tusk o' th' Brave"
"DOTA_Item_Bone_Bracer_of_the_Brave"	"Bone Bracer o' th' Brave"
"DOTA_Item_Sacral_Apparel"	"Tale-Weaver's Skirt"
"DOTA_Item_Drum_of_Tales"	"Pirate's Chantey Drum"
"DOTA_Item_Mantle_of_Mysteries"	"Mantle o' Mysteries"
"DOTA_Item_Veil_of_Fables"	"Pirate's Shroud o' Chanteys"
"DOTA_Item_Euls_Scepter_of_Divinity"	"Eul's Scepter o' Divinity"
"DOTA_Item_Hammer_Time"	"Hammer Time"
"DOTA_Item_Deathwielder"	"Sickled Shank"
"DOTA_Item_Desc_Deathwielder"	"Th' Veiled Sisters, a small group o' vicious female privateers, enjoyed anythin' sharp an' anythin' that could fell pirates in one strike."
"DOTA_Item_Ancient_Mask_of_Intimidation"	"Warp'd Mask o' Mystery"
"DOTA_Item_Announcer_Storm_Spirit"	"Announcer: Storm Spirit"
"DOTA_Item_Announcer_Pirate_Capn"	"Announcer: Pirate Captain"
"DOTA_Item_MegaKills_Pirate_Capn"	"Mega-Murders: Pirate Captain"
"DOTA_WearableType_Crown"	"Crown"
"DOTA_WearableType_Circlet"	"Circlet"
"DOTA_WearableType_Backpack"	"Backpack"
"DOTA_WearableType_Knife"	"Blade"
"DOTA_WearableType_Crest"	"Crest"
"DOTA_Item_Pugnas_Head"	"Pugna's Head"
"DOTA_Item_Pugnas_Cape"	"Pugna's Cape"
"DOTA_Item_Pugnas_Bracers"	"Pugna's Bracers"
"DOTA_Item_Pugnas_Weapon"	"Pugna's Weapon"
"DOTA_Item_Pugnas_Belt"	"Pugna's Belt"
"DOTA_Item_Brewmasters_Staff"	"Brewmaster's Staff"
"DOTA_Item_Brewmasters_Barrel"	"Brewmaster's Keg"
"DOTA_Item_Desc_Copy_of_Brewmasters_Staff"	"Arr, this 'ere loot ain't described or nothin'."
"DOTA_Item_Brewmasters_Bracers"	"Brewmaster's Bracers"
"DOTA_Item_Desc_Copy_of_Brewmasters_Barrel"	"Arr, this 'ere loot ain't described or nothin'."
"DOTA_Item_Brewmasters_Backpack"	"Brewmaster's Backpack"
"DOTA_Item_Brewmasters_Shoulders"	"Brewmaster's Shoulders"
"DOTA_Item_Desc_Copy_of_Brewmasters_Backpack"	"Arr, this 'ere loot ain't described or nothin'."
"DOTA_Item_Rikis_Horns"	"Riki's Horns"
"DOTA_Item_Desc_Copy_of_Rikis_Daggers"	" "
"DOTA_Item_Rikis_Shoulder_Armor"	"Riki's Shoulder Armor"
"DOTA_Item_Desc_Copy_of_Rikis_Horns"	" "
"DOTA_Item_Rikis_Tail"	"Riki's Tail"
"DOTA_Item_Desc_Copy_of_Rikis_Shoulder_Armor"	" "
"DOTA_Item_Rikis_Gloves"	"Riki's Gloves"
"DOTA_Item_Desc_Copy_of_Rikis_Tail"	" "
"DOTA_Item_Pugnas_Shoulder"	"Pugna's Shoulder"
"DOTA_Item_Cape_of_Arcane_Artistry"	"Cloak o' th' Vain Vogue"
"DOTA_Item_Desc_Elder_Tusk_of_the_Brave"	"This thing on me back be a lil' momento t' remind me o' that battle. I hollow'd it out so it doubles as a drinkin' mug. Cheers, mates!"
"DOTA_Item_Desc_Bone_Bracer_of_the_Brave"	"Arr, this dun come from no lad, but from somethin' much scarier an' tougher. Needless t' say 'e wasn't as tough as me."
"DOTA_Item_Desc_Sacral_Apparel"	"Arr, th' first unlucky sod t' murder th' first Chantey-Teller found 'imself in th' worst place imaginable. Not e'en death be this cruel."
"DOTA_Item_Desc_Mantle_of_Mysteries"	"\"Yer bones'll make a fine powder. Or a fine piece o' clothin'. Or a fine mantle. Yay, a fine mantle 'tis.\""
"DOTA_Item_Desc_Euls_Scepter_of_Divinity"	"Yer very own cyclone! At yer fingertips! (Warnin': Cyclone not included. See Secret Shop fer details.)"
"DOTA_Item_Desc_Ancient_Mask_of_Intimidation"	"Arr, no one seems t' know why this be 'ere. No one knows what it be based on or what it be fer. It seems t' be carved purposely an' yet no one knows. We jus' chalk it up t' boredom or lotsa rum."
"DOTA_Item_Timebreaker"	"Jewel'd Fan"
"DOTA_Item_Grand_Blade_of_the_Demigod"	"Blade o' th' Red Sea"
"DOTA_Item_Armor_of_the_Purist_Champion"	"Stolen Monk Trappin's"
"DOTA_Item_Bracer_of_the_Purist_Champion"	"Pilfer'd Monk Bracers"
"DOTA_Item_Hammer_of_the_Purist_Champion"	"Thieved Monk Hammer"
"DOTA_Item_Circlet_of_the_Purist_Champion"	"Tiny-lookin' Monk Helmet"
"DOTA_Item_Force_Staff"	"Stick wit' Ice On It"
"DOTA_Item_Desc_Force_Staff"	"Warnin': Not fer th' faint o' heart or Bloodseeker."
"DOTA_Item_Exquisite_Doubled_Axe_of_the_Veil"	"Ornate Double Axe o' th' Veil"
"DOTA_Item_Desc_Exquisite_Doubled_Axe_of_the_Veil"	"Th' Sisters be difficult t' predict at times. They either approached in th' shadows or attacked in broad daylight usin' barbaric tactics an' weaponry. Nothin' a pistol can't fix."
"DOTA_Item_Ice_Crystal_Bow"	"Frozen Bow"
"DOTA_Item_Desc_Ice_Crystal_Bow"	"\"Arr, don't tell me what t' do. I'll carry a bow o' ice if I want t'!\""
"DOTA_Item_Shuriken_of_the_Reaper"	"Th' Triple Shaver"
"DOTA_Item_BladedStaff_of_the_Reaper"	"A Really Big Shavin' Stick"
"DOTA_Item_Desc_BladedStaff_of_the_Reaper"	"Crops? Check. Heads? Check. Cookin'? Not so much."
"DOTA_Item_Makeshift_Sword_of_the_Reaper"	"Cap'n Jimmy's Cleaver"
"DOTA_Item_Desc_Darksteel_Scarf"	"Needs a desc."
"DOTA_Item_Desc_Copy_of_Creepers_Cruel_Shuriken"	"None escape th' viciousness that be th' Cap'n an' 'is ways."
"DOTA_Item_Desc_Copy_of_BladedStaff_of_the_Reaper"	"Arr, this 'ere loot ain't described or nothin'."
"DOTA_Item_Desc_Copy_of_Makeshift_Sword_of_the_Reaper"	"Arr, this 'ere loot ain't described or nothin'."
"DOTA_Item_Desc_Copy_of_Hardened_Hunters_Armor"	"Arr, sometimes a life taken ain't worth it's weight in th' coin ye pilfer."
"DOTA_Item_Elemental_Ice_Infusion"	"Frostbite"
"DOTA_Item_Bloodmist_Belt"	"Bloodmist Belt"
"DOTA_Item_Desc_Bloodmist_Belt"	"Arr, a bloody feud b'tween th' Army o' Red Mist an' th' Bloodmist raged on fer months. This be one o' th' last things that remain o' th' Army."
"DOTA_Item_Bloodmist_Helm"	"Bloodmist Cap"
"DOTA_Item_Desc_Bloodmist_Helm"	"It be no better than a bloody soup cauldron on yer head, but it 'elps build muscle if yer int' that sort o' thing."
"DOTA_Item_Bloodmist_Crescent_Axe"	"Bloodmist Curved Axe"
"DOTA_Item_Desc_Bloodmist_Crescent_Axe"	"Aye, th' Army o' th' Red Mist were bloody good shots, but not a whole lot they could do when they 'ad some Bloodmist laddie cuttin' their innards out."
"DOTA_Item_Bloodmist_Pauldrons"	"Bloodmist Spaulders"
"DOTA_Item_Desc_Bloodmist_Pauldrons"	"An Admiral o' th' Bloodmist used t' tout these 'round. That was 'til 'e met Axe. An' Axe."
"DOTA_Item_Demon_Claive"	"Demon's Claive"
"DOTA_Item_Desc_Demon_Claive"	"Not t' be confused with th' Demon Clave, a much more musical weapon."
"DOTA_Item_Bracers_of_Profound_Perfection"	"Perfectly Press'd Purple Wraps"
"DOTA_Item_Desc_Bracers_of_Profound_Perfection"	"Arr, as me mate's would like t' say when they be showin' off their recently plunder'd booty: \"Th' buggers jus' jealous I'm stylin'.\""
"DOTA_Item_Crest_of_the_Magus_Magnus"	"Mantle o' Wex"
"DOTA_Item_Hood_of_Endless_Intellect"	"Hood o' th' Marvelous Magician"
"DOTA_Item_Treasure_of_the_Pangolin_GuildMasters"	"Treasure o' th' Pangolin Guildmasters"
"DOTA_Item_The_Defense_Season_2_War_Dog"	"Th' Defense Season 2 War Dog"
"DOTA_Item_Desc_The_Defense_Season_2_War_Dog"	"A lil' somethin' fer subscribers t' Th' Defense Season 2 tourney."
"DOTA_Item_Treasure_of_the_Ancestor_Spirits"	"Treasure o' th' Ancestor Spirits"
"DOTA_Item_Treasure_of_the_High_Tide"	"Treasure o' th' High Tide"
"DOTA_Item_Sithils_Stash"	"Sithil's Summer Stash"
"DOTA_Item_Defense_2_Chest"	"Th' Defense 2 Chest"
"DOTA_Item_Desc_Defense_2_Chest"	"A lil' somethin' fer ealy subscribers t' <font color='#9da1a9'>The Defense Season 2</font> tourney. Here be a shiny new key t' open th' chest. Thank ye fer helpin' 'round th' place an' makin' th' tourney features less messy."
"DOTA_Item_MegaKills_Storm_Spirit"	"Mega-Murders: Storm Spirit"
"DOTA_Item_Strange_Modifier_Bounty_TrackedKills"	"Strange Modifier: Track'd Murders"
"DOTA_Item_Desc_Strange_Modifier_Bounty_TrackedKills"	"Addin' this 'ere Strange Modifier t' a strange piece o' loot will make it count th' number o' dyin' enemies ye were Trackin' while donnin' it as Bounty Hunter."
"DOTA_Item_Strange_Modifier_Bounty_TrackedInvisKills"	"Strange Modifier: Track'd Invisible Murders"
"DOTA_Item_Desc_Strange_Modifier_Bounty_TrackedInvisKills"	"Addin' this 'ere Strange Modifier t' a strange piece o' loot will make it count th' number o' dyin' invisible enemies ye were Tracki'n while donnin' it as Bounty Hunter."
"DOTA_Item_Strange_Modifier_Bounty_InvisJinadaHits"	"Strange Modifier: Invisible Jinada Strikes"
"DOTA_Item_Desc_Strange_Modifier_Bounty_InvisJinadaHits"	"Addin' this 'ere Strange Modifier t' a strange piece o' loot will make it count th' number o' times ye break invisibility with a Jinada strike on a enemy admiral while donnin' it as Bounty Hunter."
"DOTA_Item_Strange_Modifier_Bounty_TrackBountyGold"	"Strange Modifier: Track Bounty Coin"
"DOTA_Item_Desc_Strange_Modifier_Bounty_TrackBountyGold"	"Addin' this 'ere Strange Modifier t' a strange piece o' loot will make it count th' total bonus coin ye've earn'd from Track'd murders while donnin' it as Bounty Hunter."
"DOTA_Item_Strange_Modifier_Tide_GoodRavages"	"Strange Modifier: Quad Ravages"
"DOTA_Item_Desc_Strange_Modifier_Tide_GoodRavages"	"Addin' this 'ere Strange Modifier t' a strange piece o' loot will make it count th' number o' yer Ravages that hit at least four enemy Admirals while donnin' it as Tidehunter."
"DOTA_Item_Strange_Modifier_Windrunner_DoubleShackles"	"Strange Modifier: Double Shackles"
"DOTA_Item_Desc_Strange_Modifier_Windrunner_DoubleShackles"	"Addin' this 'ere Strange Modifier t' a strange piece o' loot will make it count th' number o' yer Shackshots that bind two enemy Admirals while donnin' it as Windranger."
"DOTA_Item_Strange_Modifier_Windrunner_GoodPowershots"	"Strange Modifier: Multi-admiral Powershots"
"DOTA_Item_Desc_Strange_Modifier_Windrunner_GoodPowershots"	"Addin' this 'ere Strange Modifier t' a strange piece o' loot will make it count th' number o' yer Powershots that hit at least two enemy Admirals while donnin' it as Windranger."
"DOTA_Item_Strange_Modifier_Invoker_SunstrikeKills"	"Strange Modifier: Sunstrike Murders"
"DOTA_Item_Desc_Strange_Modifier_Invoker_SunstrikeKills"	"Addin' this 'ere Strange Modifier t' a strange piece o' loot will make it track th' number o' enemies ye've murder'd with Sunstrike as Invoker."
"DOTA_Item_Strange_Modifier_Couriers_Purchased"	"Strange Modifier: Couriers Acquired"
"DOTA_Item_Desc_Strange_Modifier_Couriers_Purchased"	"Addin' this 'ere Strange Modifier t' a strange piece o' loot will make it count th' number o' Couriers acquired."
"DOTA_Item_Strange_Modifier_Wards_Purchased"	"Strange Modifier: Wards Acquired"
"DOTA_Item_Strange_Modifier_Tide_EnemiesGushed"	"Strange Modifier: Enemies Gush'd"
"DOTA_Item_Desc_Strange_Modifier_Tide_EnemiesGushed"	"Addin' this 'ere Strange Modifier t' a strange piece o' loot will make it count th' number o' enemies ye've Gush'd as Tidehunter."
"DOTA_Item_Treasure_Key_Summer_Sale"	"Sithil's Summer Key"
"DOTA_Item_Desc_Treasure_Key_Summer_Sale"	"Used t' open <font color='#9da1a9'>Sithil's Summer Stash</font>. After th' end o' <font color='#9da1a9'>July 31, 2012</font> this'll become a bog-standard key."
"DOTA_Item_Treasure_Key_Defense_2"	"Th' Defense 2 Key"
"DOTA_Item_League_StarLadderS2"	"Star Series Season II Lan Final"
"DOTA_Item_League_BeyondTheSummit"	"BeyondTheSummit World Tour"
"DOTA_Item_The_Dauntless_Set"	"Set o' th' Dauntless"
"DOTA_Bundle_Desc_Juggernaut_Dauntless"	"Arr, 'as all th' loot needed t' craft th' \"Set o' th' Dauntless\" fer Juggernaut:"
"DOTA_Item_Bloodmist_Armor_Set"	"Bloodmist Armor Set"
"DOTA_Bundle_Desc_Axe_Blood_Mist"	"Arr, 'as all th' loot t' make yer own 'Bloodmist Armor' set fer Axe:"
"DOTA_Item_Armor_of_Sir_Davion_Set"	"Cap'n Davion's Legacy Set"
"DOTA_Bundle_Desc_Dragon_Knight_Davion"	"Arr, 'as all th' loot needed t' craft yer own 'Cap'n Davion's Legacy' set fer Dragon Knight:"
"DOTA_Item_Traveling_TaleTellers_Set"	"Travelin' Chantey-Teller's Set"
"DOTA_Bundle_Desc_Witch_Doctor_Tale_Teller"	"Arr, 'as all th' loot needed t' craft yer own 'Travelin' Chantey Teller' set fer Witch Doctor:"
"DOTA_Item_Hardened_Hunters_Gear_Set"	"A Set o' Reinforced Leather Gear"
"DOTA_Bundle_Desc_Bounty_Hunter_Hardened"	"Arr, 'as all th' loot ye need t' craft th' 'Reinforced Leather Gear' set fer Bounty Hunter:"
"DOTA_Item_The_Magus_Magnus_Set"	"Th' Power o' Wex Set"
"DOTA_Bundle_Desc_Invoker_Magnus"	"Ar, 'as all th' loot ye need t' craft yer own 'Magus Magnus' set fer Invoker:"
"DOTA_Bundle_Summer_2012"	"Sithil's Summer Bundle"
"DOTA_Bundle_Desc_Summer_2012"	"A huge chest that be 'avin' a pile o' 47 pieces o' loot, includin':"
"DOTA_Item_Death_Prophets_Dress"	"Death Prophet's Dress"
"DOTA_Item_Death_Prophets_Arms"	"Death Prophet's Arms"
"DOTA_Item_Death_Prophets_Head"	"Death Prophet's Head"
"DOTA_Item_Death_Prophets_Scarf"	"Death Prophet's Scarf"
"DOTA_Item_Death_Prophets_Vortex"	"Death Prophet's Vortex"
"DOTA_Item_Lanayas_hair"	"Lanayas hair"
"DOTA_Item_Lanayas_shoulders"	"Lanayas shoulders"
"DOTA_Item_Lanayas_bracers_and_skirt"	"Lanayas bracers an' skirt"
"DOTA_Item_Chaos_Knights_horse_head"	"Chaos Knights Horse Head"
"DOTA_Item_Chaos_Knight_horse_amor"	"Chaos Knight Horse Armor"
"DOTA_Item_Chaos_Knight_shoulderpads"	"Chaos Knight shoulderpads"
"DOTA_Item_Chaos_Knight_helmet"	"Chaos Knight helmet"
"DOTA_Item_Chaos_Knight_weapon"	"Chaos Knight weapon"
"DOTA_Item_Chaos_Knight_shield"	"Chaos Knight shield"
"DOTA_Item_Obsidian_Destroyers_head"	"Obsidian Destroyers head"
"DOTA_Item_Obsidian_Destroyers_armor"	"Obsidian Destroyers armor"
"DOTA_Item_Obsidian_Destroyers_weapon"	"Obsidian Destroyers weapon"
"DOTA_Item_Obsidian_Destroyers_wings"	"Obsidian Destroyers wings"
"DOTA_Item_Naga_Sirens_Hair"	"Naga Siren's Hair"
"DOTA_Item_Naga_Sirens_Swords"	"Naga Siren's Swords"
"DOTA_Item_Naga_Sirens_Tail"	"Naga Siren's Tail"
"DOTA_Item_Naga_Sirens_Armor"	"Naga Siren's Armor"
"DOTA_Item_League_BeyondTheSummit_Admin"	"BeyondTheSummit World Tour Admin"
"DOTA_Item_Crystal_Maidens_Cuffs"	"Crystal Maiden's Cuffs"
"DOTA_Item_Gyrocopters_Bottles"	"Gyrocopter's Bottles"
"DOTA_Item_Gyrocopters_Gloves"	"Gyrocopter's Gloves"
"DOTA_Item_Gyrocopters_Goggles"	"Gyrocopter's Goggles"
"DOTA_Item_Gyrocopters_Guns"	"Gyrocopter's Guns"
"DOTA_Item_Gyrocopters_Propeller"	"Gyrocopter's Propeller"
"DOTA_Item_Gyrocopters_Homing_Missile"	"Gyrocopter's Homing Missile"
"DOTA_Item_Sand_Kings_Head"	"Sand King's Head"
"DOTA_Item_Nyxs_Weapon"	"Nyx's Weapon"
"DOTA_Item_Nyxs_Armor"	"Nyx's Armor"
"DOTA_Item_Desc_Copy_of_Nyxs_Weapon"	"Arr, this 'ere loot ain't described or nothin'."
"DOTA_Item_Nyxs_Helmet"	"Nyx's Helmet"
"DOTA_Item_Desc_Copy_of_Nyxs_Armor"	"Arr, this 'ere loot ain't described or nothin'."
"DOTA_Item_Sand_Kings_Armor"	"Sand King's Armor"
"DOTA_Item_Sand_Kings_Arms"	"Sand King's Arms"
"DOTA_Item_Sand_Kings_Legs"	"Sand King's Legs"
"DOTA_Item_Sand_Kings_Tail"	"Sand King's Tail"
"DOTA_Item_Assault_Armor_Belt"	"Assault Armor Belt"
"DOTA_Item_Assault_Armor_Shoulders"	"Assault Armor Shoulders"
"DOTA_Item_Assault_Armor_Bracer"	"Assault Armor Bracer"
"DOTA_Item_Assault_Armor_Helmet"	"Assault Armor Helmet"
"DOTA_Item_Heavy_Crusher"	"Heavy Crusher"
"DOTA_Item_Ruling_Sword"	"Rulers Cutlass"
"DOTA_Item_Metal_Horns"	"Metal Horns"
"DOTA_Item_Horseshoe_crab"	"Horseshoe crab"
"DOTA_Item_Echinoderm_shield"	"Echinoderm shield"
"DOTA_Item_Tortoise_Paddle"	"Turtle Paddle"
"DOTA_Item_Spiked_Bracers_of_the_Ravager"	"Spiked Bracers o' th' Ravager"
"DOTA_Item_Sash_of_the_Ravager"	"Sash o' th' Ravager"
"DOTA_Item_Skull_of_the_Ravager"	"Skull o' th' Ravager"
"DOTA_Item_Quills_of_the_Ravager"	"Quills o' th' Ravager"
"DOTA_Item_Master_Assassins_Shurken"	"Master Assassins Shuriken"
"DOTA_Item_Tails_of_the_Master_Assassin"	"Tails o' th' Master Assassin"
"DOTA_Item_Master_Assassins_Shoulders"	"Master Assassin's Pauldrons"
"DOTA_Item_Master_Assassins_Mask"	"Master Assassin's Mask"
"DOTA_Item_Master_Assassins_Weapon"	"Master Assassins Weapon"
"DOTA_Item_Master_Assassins_Offhand_Weapon"	"Master Assassins Offhand Weapon"
"DOTA_Item_Reaver"	"Volcanic Shard"
"DOTA_Item_JawTrap"	"JawTrap"
"DOTA_Item_Hood_of_the_Hierophant"	"Cowl o' th' Dead Prophet"
"DOTA_Item_Chestplate_of_the_Hierophant"	"Armor o' th' Dead Prophet"
"DOTA_Item_Armor_of_the_Hierophant"	"Armor o' th' Hierophant"
"DOTA_Item_Holy_Words_of_the_Hierophant"	"Whispers o' th' Dead Prophet"
"DOTA_Item_Bracers_of_the_Hierophant"	"Wraps o' th' Dead Prophet"
"DOTA_Item_Nightmare_Blade"	"Fleshweaver's Blade"
"DOTA_Item_BloodLetter_Right"	"BloodLetter (Right)"
"DOTA_Item_BloodLetter_Left"	"BloodLetter (Left)"
"DOTA_Item_Tempest_sight_axe"	"Tempest sight axe"
"DOTA_Item_Blood_Ravager"	"Blood Ravager"
"DOTA_Item_League_Prodota2WL"	"Prodota 2 Worldwide League"
"DOTA_Item_League_Prodota2WL_Admin"	"Prodota 2 Worldwide League ADMIN"
"DOTA_WearableType_Booby_Trap"	"Booby Trap"
"DOTA_Item_Obsidian_Destroyers_horns"	"Obsidian Destroyers horns"
"DOTA_Item_Desc_Obsidian_Destroyers_head"	"Arr, this 'ere loot ain't described or nothin'."
"DOTA_Item_Phantom_Assassins_Head"	"Phantom Assassin's Head"
"DOTA_Item_Rubicks_Staff"	"Rubick's Staff"
"DOTA_Item_Rubicks_Cape"	"Rubick's Cape"
"DOTA_Item_Desc_Copy_of_Rubicks_Staff"	"Arr, this 'ere loot ain't described or nothin'."
"DOTA_Item_Rubicks_Shoulder_Armor"	"Rubick's Shoulder Armor"
"DOTA_Item_Desc_Copy_of_Rubicks_Cape"	"Arr, this 'ere loot ain't described or nothin'."
"DOTA_Item_Lycans_Blades"	"Lycan's Blades"
"DOTA_Item_Lycans_Head"	"Lycan's Head"
"DOTA_Item_Lycans_Armor"	"Lycan's Armor"
"DOTA_Item_Lycans_Fur"	"Lycan's Fur"
"DOTA_Item_Lycans_Belt"	"Lycan's Belt"
"DOTA_Item_Necrolytes_Sickle"	"Necrolyte's Sickle"
"DOTA_Item_Necrolytes_Beard"	"Necrolyte's Beard"
"DOTA_Item_Desc_Copy_of_Necrolytes_Sickle"	"Arr, this 'ere loot ain't described or nothin'."
"DOTA_Item_Necrolytes_Headdress"	"Necrolyte's Headdress"
"DOTA_Item_Desc_Copy_of_Necrolytes_Beard"	"Arr, this 'ere loot ain't described or nothin'."
"DOTA_Item_Necrolytes_Vestments"	"Necrolyte's Vestments"
"DOTA_Item_Desc_Copy_of_Necrolytes_Headdress"	"Arr, this 'ere loot ain't described or nothin'."
"DOTA_Item_AntiMages_Head"	"Anti-Mage's Head"
"DOTA_Item_AntiMages_Shoulder"	"Anti-Mage's Shoulder"
"DOTA_Item_AntiMages_Arms"	"Anti-Mage's Arms"
"DOTA_Item_AntiMages_Belt"	"Anti-Mage's Belt"
"DOTA_Item_Lone_Druids_Weapon"	"Lone Druid's Weapon"
"DOTA_Item_Chens_Staff"	"Chen's Staff"
"DOTA_Item_Chens_Mount"	"Chen's Mount"
"DOTA_Item_Desc_Copy_of_Chens_Staff"	"Arr, this 'ere loot ain't described or nothin'."
"DOTA_Item_Chens_Helmet"	"Chen's Helmet"
"DOTA_Item_Desc_Copy_of_Chens_Mount"	"Arr, this 'ere loot ain't described or nothin'."
"DOTA_Item_Chens_Bracers"	"Chen's Bracers"
"DOTA_Item_Desc_Copy_of_Chens_Helmet"	"Arr, this 'ere loot ain't described or nothin'."
"DOTA_Item_Chens_Shoulder_Armor"	"Chen's Shoulder Armor"
"DOTA_Item_Desc_Copy_of_Chens_Bracers"	"Arr, this 'ere loot ain't described or nothin'."
"DOTA_Item_Chens_Mount_Armor"	"Chen's Mount Armor"
"DOTA_Item_Desc_Copy_of_Chens_Shoulder_Armor"	"Arr, this 'ere loot ain't described or nothin'."
"DOTA_Item_Treants_Head"	"Treants' Head"
"DOTA_Item_Treants_Foliage"	"Treants' Foliage"
"DOTA_Item_Desc_Copy_of_Treants_Head"	"Arr, this 'ere loot ain't described or nothin'."
"DOTA_Item_Treants_Hands"	"Treants' Hands"
"DOTA_Item_Desc_Copy_of_Treants_Foliage"	"Arr, this 'ere loot ain't described or nothin'."
"DOTA_Item_Treants_Feet"	"Treants' Feet"
"DOTA_Item_Desc_Copy_of_Treants_Hands"	"Arr, this 'ere loot ain't described or nothin'."
"DOTA_Item_Treants_Belt"	"Treants' Belt"
"DOTA_Item_Desc_Copy_of_Treants_Feet"	"Arr, this 'ere loot ain't described or nothin'."
"DOTA_Item_Beast_of_War_Belt"	"Beast o' War Belt"
"DOTA_Item_Beast_of_War_Plates"	"Beast o' War Plates"
"DOTA_Item_Beast_of_War_Bracers"	"Beast o' War Bracers"
"DOTA_Item_Beast_of_War_Helm"	"Beast o' War Helm"
"DOTA_Item_Master_Assassins_Shuriken"	"Master Assassin's Shuriken"
"DOTA_Item_Master_Assassins_Tails"	"Master Assassin's Tails"
"DOTA_Item_Master_Assassins_Mancatcher"	"Master Assassin's Mancatcher"
"DOTA_Item_Master_Assassins_Grim_Cutter"	"Master Assassin's Grim Cutter"
"DOTA_Item_Trap_Jaw"	"Trap Jaw"
"DOTA_Item_TempestSight_Axe"	"Tempest-Sight Axe"
"DOTA_Item_Dragonblood_Ravager"	"Dragonblood Ravager"
"DOTA_Item_Hammer_of_Hope"	"Shiny Lookin' Hammer"
"DOTA_Item_Shard_of_the_Rift"	"Glowin' Rift Stone"
"DOTA_Item_Blade_of_Dead_Kings"	"Blade o' Dead Kings"
"DOTA_Item_Savage_Beast_Arms"	"Really Hairy Arms"
"DOTA_Item_Savage_Beast_Shoulders"	"Really Hairy Shoulders"
"DOTA_Item_Savage_Beast_Belt"	"Really Hairy Feet"
"DOTA_Item_Savage_Beast_Head"	"Really Hairy Head"
"DOTA_Item_Savage_Beast_Weapon_Right"	"Savage Beast Weapon (Right)"
"DOTA_Item_Savage_Beast_Weapon_Left"	"Savage Beast Weapon (Left)"
"DOTA_Item_Savage_Beast_Armor"	"Really Hairy Armor"
"DOTA_Item_Savage_Helmet"	"Savage Helmet"
"DOTA_Item_Savage_Armor"	"Savage Armor"
"DOTA_Item_Savage_Bracer"	"Savage Bracer"
"DOTA_Item_Savage_Belt"	"Savage Belt"
"DOTA_Item_Shivas_Frost_Scepter"	"Shiva's Frost Scepter"
"DOTA_Item_Rune_Inscribed_Cleaver"	"Rune Inscribed Cleaver"
"DOTA_Item_HeadAche"	"Head-Ache"
"DOTA_Item_League_MachinimaECAL_America"	"Machinima ECAL: Americas"
"DOTA_Item_Desc_League_MachinimaECAL_America"	"ECAL playoffs be featurin' 3 crews from Th' International: EG, coL, an' aL along wit' up an' comin' crews in th' competitive scene like Quantic Gaming an' POTM BOTTOM. Thar be $3,000 prize pool sponsor'd by Machinima that'll be offer'd t' th' victors."
"DOTA_Item_League_MachinimaECAL_America_Admin"	"Machinima ECAL: Americas ADMIN"
"DOTA_Item_League_TheInternal"	"Th' Internal"
"DOTA_Item_Desc_League_TheInternal"	"This 'ere be a testin' tourney fer th' inner workin's that'll be used fer Th' International. Watch th' best pirates o' th' Bellevue seas fer th' glory o' makin' their mateys green wit' envy."
"DOTA_Item_League_TheInternal_Admin"	"Th' Internal ADMIN"
"DOTA_Item_Dooms_Weapon"	"Doom's Weapon"
"DOTA_Item_Dooms_Helm"	"Doom's Helm"
"DOTA_Item_Desc_Copy_of_Dooms_Weapon"	"Arr, this 'ere loot ain't described or nothin'."
"DOTA_Item_Dooms_Shoulder_Armor"	"Doom's Shoulder Armor"
"DOTA_Item_Desc_Copy_of_Dooms_Helm"	"Arr, this 'ere loot ain't described or nothin'."
"DOTA_Item_Dooms_Bracers"	"Doom's Bracers"
"DOTA_Item_Desc_Copy_of_Dooms_Shoulder_Armor"	"Arr, this 'ere loot ain't described or nothin'."
"DOTA_Item_Dooms_Belt"	"Doom's Belt"
"DOTA_Item_Desc_Copy_of_Dooms_Bracers"	"Arr, this 'ere loot ain't described or nothin'."
"DOTA_Item_Dooms_Wings"	"Doom's Wings"
"DOTA_Item_Desc_Copy_of_Dooms_Belt"	"Arr, this 'ere loot ain't described or nothin'."
"DOTA_Item_Dooms_Tail"	"Doom's Tail"
"DOTA_Item_Desc_Copy_of_Dooms_Wings"	"Arr, this 'ere loot ain't described or nothin'."
"DOTA_Item_Warlocks_Weapon"	"Warlock's Weapon"
"DOTA_Item_Warlocks_Offhand_Weapon"	"Warlock's Off-hand Weapon"
"DOTA_Item_Warlocks_Head"	"Warlock's Head"
"DOTA_Item_Warlocks_Shoulder"	"Warlock's Shoulder"
"DOTA_Item_Warlocks_Arms"	"Warlock's Arms"
"DOTA_Item_Warlocks_Robe"	"Warlock's Robe"
"DOTA_Item_Warlocks_Bag"	"Warlock's Bag"
"DOTA_Item_Shadow_Shamans_Weapon"	"Shadow Shaman's Weapon"
"DOTA_Item_Shadow_Shamans_Offhand_Weapon"	"Shadow Shaman's Off-hand Weapon"
"DOTA_Item_Desc_Copy_of_Shadow_Shamans_Weapon"	"Arr, this 'ere loot ain't described or nothin'."
"DOTA_Item_Shadow_Shamans_Headdress"	"Shadow Shaman's Headdress"
"DOTA_Item_Desc_Copy_of_Shadow_Shamans_Offhand_Weapon"	"Arr, this 'ere loot ain't described or nothin'."
"DOTA_Item_Shadow_Shamans_Armor"	"Shadow Shaman's Armor"
"DOTA_Item_Desc_Copy_of_Shadow_Shamans_Headdress"	"Arr, this 'ere loot ain't described or nothin'."
"DOTA_Item_Shadow_Shamans_Stuff"	"Shadow Shaman's Junk"
"DOTA_Item_Desc_Copy_of_Shadow_Shamans_Armor"	"Arr, this 'ere loot ain't described or nothin'."
"DOTA_Item_Shadow_Shamans_Head"	"Shadow Shaman's Head"
"DOTA_Item_Desc_Copy_of_Shadow_Shamans_Stuff"	"Arr, this 'ere loot ain't described or nothin'."
"DOTA_Item_Strange_Modifier_Axe_Culls"	"Strange Modifier: Enemies Cull'd"
"DOTA_Item_Desc_Strange_Modifier_Axe_Culls"	"Addin' this 'ere Strange Modifier t' a strange piece o' loot will make it count t' number o' enemies ye've Cull'd while donnin' it as Axe."
"DOTA_Item_Strange_Modifier_Axe_BattleHungerKills"	"Strange Modifier: Battle Hunger Kills"
"DOTA_Item_Desc_Strange_Modifier_Axe_BattleHungerKills"	"Addin' this 'ere Strange Modifier t' a strange piece o' loot will make it count th' number o' enemies ye've murder'd with Battle Hunger while donnin' it as Axe."
"DOTA_Item_Strange_Modifier_Axe_LowHealthKills"	"Strange Modifier: Axe Near Death Kills"
"DOTA_Item_Desc_Strange_Modifier_Axe_LowHealthKills"	"Addin' this 'ere Strange Modifier t' a strange piece o' loot will make it count th' number o' enemies ye've murder'd while havin' less than 15% of yer life while donnin' it as Axe."
"DOTA_Item_Strange_Modifier_Axe_CalledDamageDone"	"Strange Modifier: Call Damage Done"
"DOTA_Item_Desc_Strange_Modifier_Axe_CalledDamageDone"	"Addin' this 'ere Strange Modifier t' some strange loot will let it count th' 'mount o' damage ye've done t' foes while affect'd by yer Berserker's Call while donnin' it as Axe."
"DOTA_Item_Strange_Modifier_Axe_CalledDamageTaken"	"Strange Modifier: Call Damage Taken"
"DOTA_Item_Desc_Strange_Modifier_Axe_CalledDamageTaken"	"Addin' this 'ere Strange Modifier t' some strange loot will let it count th' 'mount o' damage ye've taken from foes while affect'd by yer Berserker's Call as Axe."
"DOTA_Item_League_AbsoluteArenaKOH"	"AbsoluteArena King o' th' Hill"
"DOTA_Item_League_AbsoluteArenaKOH_Admin"	" "
"DOTA_Item_Strange_Modifier_Invoker_TornadoKills"	"Strange Modifier: Tornado Murders"
"DOTA_Item_Desc_Strange_Modifier_Invoker_TornadoKills"	"Addin' this 'ere Strange Modifier t' a strange piece o' loot will make it track t' number o' foes slain by a Tornado as Invoker."
"DOTA_WearableType_Blade"	"Blade"
"DOTA_WearableType_Platemail"	"Platemail"
"DOTA_WearableType_Book"	"Tome"
"DOTA_WearableType_Guard"	"Guard"
"DOTA_WearableType_Ward"	"Ward"
"DOTA_WearableType_Cask"	"Barrel"
"DOTA_WearableType_Flail"	"Flail"
"DOTA_WearableType_Sickle"	"Sickle"
"DOTA_WearableType_Short_Blades"	"Short Blades"
"DOTA_WearableType_Bottle"	"Bottle"
"DOTA_WearableType_Belly_Guard"	"Girdle"
"DOTA_WearableType_Club"	"Club"
"DOTA_WearableType_Cloak"	"Cloak"
"DOTA_WearableType_International_Courier"	"International Courier"
"DOTA_WearableType_Fan"	"Fan Loot"
"DOTA_Item_Blood_Seekers_Blade"	"Blood Seeker's Blade"
"DOTA_Item_KotL_Mount"	"KotL Mount"
"DOTA_Item_Desc_KotL_Mount"	"
"
"DOTA_Item_KotL_Staff"	"KotL Staff"
"DOTA_Item_Desc_KotL_Weapon"	"
"
"DOTA_Item_KotL_Hood"	"KotL Cowl"
"DOTA_Item_KotL_Skirt"	"KotL Skirt"
"DOTA_Item_Desc_KotL_Skirt"	"
"
"DOTA_Item_KotL_Horse_Accesories"	"KotL Horse Accesories"
"DOTA_Item_Desc_KotL_Horse_Accesories"	"Horse armor ain't cheap, lad."
"DOTA_Item_back_rings"	"
"
"DOTA_Item_Desc_back_rings"	"
"
"DOTA_Item_cleaver"	"
"
"DOTA_Item_Desc_Copy_of_back_rings"	"
"
"DOTA_Item_left_arm"	"
"
"DOTA_Item_Desc_left_arm"	"
"
"DOTA_Item_bracer"	"
"
"DOTA_Item_Desc_Copy_of_left_arm"	"
"
"DOTA_Item_hair"	"
"
"DOTA_Item_Dazzles_mohawk"	"Dazzles Mohawk"
"DOTA_Item_Dazzles_staff"	"Dazzles Staff"
"DOTA_Item_Dazzles_dress"	"Dazzles Dress"
"DOTA_Item_Dazzles_sleeve"	"Dazzles Sleeve"
"DOTA_Item_Desc_Cerebral_Support"	"What great an' mighty beast o' th' olden days once wore this? Tidehunter certainly cares not."
"DOTA_Item_Desc_Skeletal_Catch"	"Got yer meat off me bones, me thinks. Another stab should be doin' it."
"DOTA_Item_War_Blade__OffHand"	"Blood Guzzler's Off-Hand Blade o' War"
"DOTA_Item_Desc_Armor_of_the_Purist_Champion"	"Omniknight wears all o' this kind o' stuff wit' pride."
"DOTA_Item_Desc_Circlet_of_the_Purist_Champion"	"Fer Omniknight, no show o' loyalty be too great."
"DOTA_Item_Iron_Bears_Belt"	"Iron Grizzly's Belt"
"DOTA_Item_Desc_Iron_Bears_Belt"	"It be quite rare t' find such a useful ruin from th' Tribal Wars still in one piece."
"DOTA_Item_Iron_Bears_Plates"	"Iron Grizzly's Plates"
"DOTA_Item_Desc_Iron_Bears_Pauldrons"	"Durin' th' Tribal Wars, th' etchin' on th' shoulders was used t' mark yer homeland an' clan should ye bearer fall in battle."
"DOTA_Item_Iron_Bears_Cutter"	"Iron Grizzly's Cutter"
"DOTA_Item_Desc_Iron_Bears_Cutter"	"Until th' Tribal Wars, th' Ursa clan never thought t' cover 'emselves in armor. Now th' war be forgotten, an' such arms be fer showin' off rather than protectin'."
"DOTA_Item_Iron_Bears_Skullcap"	"Iron Grizzly's Skullcap"
"DOTA_Item_Desc_Iron_Bears_Skullcap"	"A relic o' th' Tribal Wars, this cap were supposed t' belong t' a powerful chieftain. At least, that's what th' bloke who sold me it said..."
"DOTA_Item_Desc_Horseshoe_Crab"	"At times Tidehunter wants somethin' a bit more crunchy than Kunkka."
"DOTA_Item_Desc_Echinoderm_Shield"	"What th' Tidehunter chooses t' keep as a pet be his own business."
"DOTA_Item_Desc_Tortoise_Paddle"	"O' th' creatures o' th' sea, Tidehunter be th' epitome o' modesty. When it comes t' inventin' weaponry, he's all show, no talk."
"DOTA_Item_Desc_Spiked_Bracers_of_the_Ravager"	"T' slay a ravager be a sacred rite fer th' ursa, an' nary a single bit o' th' carcass be wasted."
"DOTA_Item_Desc_Sash_of_the_Ravager"	"Made from th' belly o' a fallen foe. Yeesh!"
"DOTA_Item_Desc_Skull_of_the_Ravager"	"Only th' fiercest hunter may lay claim t' th' skull o' a spiked ravager."
"DOTA_Item_Desc_Master_Assassins_Grim_Cutter"	"Let this here tip slice through any sort o' shield like smooth, smooth butter."
"DOTA_Item_Desc_Trap_Jaw"	"Thar be more t' catchin' prey than just stalkin' them through th' woods."
"DOTA_Item_Desc_Hood_of_the_Hierophant"	"Th' Dead Prophet wrap'd himself up well, t' protect 'gainst th' elements on his many pilgrimages."
"DOTA_Item_Desc_Chestplate_of_the_Hierophant"	"Th' Dead Prophet were protect'd by more then just physical arms. In th' end though, it wasn't enough."
"DOTA_Item_Heavy_Pauldrons_of_the_Hierophant"	"Heavy Pauldrons o' th' Dead Prophet"
"DOTA_Item_Desc_Armor_of_the_Hierophant"	"Th' Dead Prophet clad 'imself in heavy armor t' remind himself o' th' weight o' responsibility he was under. It came in handy fer protection too, o' course."
"DOTA_Item_Desc_Holy_Words_of_the_Hierophant"	"Th' Dead Prophet always spoke his prophecies in whispers - a mark o' respect fer words o' immense importance."
"DOTA_Item_Desc_Bracers_of_the_Hierophant"	"Th' Dead Prophet was always guarded 'gainst any threat... 'cept that which kill'd 'im."
"DOTA_Item_Bloodletter"	"Bloodletter"
"DOTA_Item_Desc_Bloodletter"	"A vicious, pointed edge that be useful fer things other than bloodlettin', that's fer sure."
"DOTA_Item_Bloodletter__OffHand"	"Bloodletter - Off-Hand"
"DOTA_Item_Desc_Bloodletter__OffHand"	"A vicious, pointed edge that be useful fer things other than bloodlettin', that's fer sure."
"DOTA_Item_Desc_TempestSight_Axe"	"Arr, thar be some strange things ye can find in wrecked ships. Most of it be corpses, but that be typical."
"DOTA_Item_Desc_Shard_of_the_Rift"	"At some points in time, we find these glowin' stones along th' shores. They glow brightly an' dun seem affect'd by wherever they be. Lads that 'old ont' 'em lose track o' time easily though..."
"DOTA_Item_Bonehunter_Bracers"	"Bonehunter Skin Wraps"
"DOTA_Item_Desc_Bonehunter_Bracers"	"Arr, thar be tales o' mates who be cursed t' sail an' plunder th' drylands. Th' beasties be nasty, but none match th' horrors 'o th' Bonehunters."
"DOTA_Item_Bonehunter_Tuskguard"	"Bonehunter Tusk'd Shoulders"
"DOTA_Item_Desc_Bonehunter_Tuskguard"	"They say Bonehunters wear th' teeth o' their most vicious kill. Why dun they 'ave me Cap'ns teeth then?"
"DOTA_Item_Bonehunter_Belt"	"Bonehunter Sash"
"DOTA_Item_Desc_Bonehunter_Belt"	"A sash o' red, drench'd wit' th' fresh color an' stench o' blood."
"DOTA_Item_Bonehunter_Skullguard"	"Bonehunter Skullguard"
"DOTA_Item_Desc_Bonehunter_Skullguard"	"Th' Bonehunters be e'er vicious an' cunnin'. They e'en use th' skulls o' th' fallen t' fool their prey."
"DOTA_Item_Bonehunter_Slicer"	"Bonehunter Bonesplinter"
"DOTA_Item_Desc_Bonehunter_Slicer"	"Dun let th' weapons fool ye. They dun look any tougher than a fist, but bone cuts metal like no other."
"DOTA_Item_Bonehunter_Slicer__OffHand"	"Bonehunter Bonesplinter - Off-Hand"
"DOTA_Item_Desc_Bonehunter_Slicer__OffHand"	"Dun let th' weapons fool ye. They dun look any tougher than a fist, but bone cuts metal like no other."
"DOTA_Item_Bonehunter_Spineguard"	"Bonehunter Spineguard"
"DOTA_Item_Desc_Bonehunter_Spineguard"	"Thar be a bit o' wisdom in th' Bonehunters. If somethin' be good 'nuff t' protect ye from inside ye, it should be good 'nuff on th' outside!"
"DOTA_Item_Helm_of_a_Savage_Age"	"Helm o' a Savage Era"
"DOTA_Item_Desc_Savage_Helmet"	"A fancy headgarb t' honor th' ferocity o' a savage era."
"DOTA_Item_Armor_of_a_Savage_Age"	"Armor o' a Savage Era"
"DOTA_Item_Desc_Savage_Armor"	"In a savage age, 'fore th' Ursa earn'd th' gift o' speech, they displayed their alliances an' homelands wit' fancy-lookin' posh patterns. I prefer t' use a flag meself!"
"DOTA_Item_Bracer_of_a_Savage_Age"	"Bracer o' a Savage Era"
"DOTA_Item_Desc_Savage_Bracer"	"In a fancy ceremony on honor'd days, th' Ursa remember a savage time 'fore they earn'd th' gift o' speech."
"DOTA_Item_Belt_of_a_Savage_Age"	"Belt o' a Savage Era"
"DOTA_Item_Desc_Savage_Belt"	"A festive coverin' representin' a savage time before th' Ursa o' olden days earn'd th' gift o' speech."
"DOTA_Item_Desc_Shivas_Frost_Scepter"	"Two-Ships Tim told me a tale o' a scepter what lies at th' bottom o' a frozen lake, in a land ferever torment'd by a swirlin' blizzard. Two months later I 'eard from Tim again. He tells me the scepter went missin'! They got no clue which scallwag took it, or how he did it. We'll prob'ly never know fer sure."
"DOTA_Item_Desc_Rune_Inscribed_Cleaver"	"Th' runes let ye see visions o' th' afterlife should ye be cut by th' blade, apparently. Sounds like a load o' hogwash t' me."
"DOTA_Item_Desc_HeadAche"	"\"Arr, ye got teeth growin' on yer head matey. Drink more rum, it'll go away. Prob'ly.\""
"DOTA_Item_Rhuis_TuningFork"	"Tunin'-Fork o' th' Sea"
"DOTA_Item_Desc_Rhuis_TuningFork"	"Perfect fer skewin' an' filletin' yer foes."
"DOTA_Item_Carved_Grin_of_the_Trickster"	"Crooked Grin o' th' Jester"
"DOTA_Item_Desc_Carved_Grin_of_the_Trickster"	"Arr, why so serious Yurnero?"
"DOTA_Item_Summoners_Tambourine"	"Summoner's Tambourine"
"DOTA_Item_Desc_Summoners_Tambourine"	"This be about th' most complicated instrument a pirate can hope t' play well."
"DOTA_Item_Legions_Wrath"	"Legion's Wrath"
"DOTA_Item_Desc_Legions_Wrath"	"In th' hands o' one, ye can't do much wit' such a lance. In th' hands o' many, however..."
"DOTA_Item_Deros_Staff_of_Sanity"	"Dero's Staff o' Sanity"
"DOTA_Item_Desc_Deros_Staff_of_Sanity"	"They reckon if ye grip such a weapon yer mind be safeguard'd an' secure. I say if ye believe that, yer mind's beyond savin'."
"DOTA_Item_Berserkers_Witchslayer"	"Berserker's Witchslayer"
"DOTA_Item_Desc_Berserkers_Witchslayer"	"Th' runes along th' edge defend it 'gainst magicks that would seek t' disarm th' wielder."
"DOTA_Item_Crown_of_the_Comets_Tail"	"Crown o' th' Comet's Tail"
"DOTA_Item_Desc_Crown_of_the_Comets_Tail"	"While they be unknown t' scholars o' landlubber hist'ry, th' mythologies o' sea-dwelling creatures oft look t' th' moon an' stars fer wisdom an' guidance. We just use 'em t' navigate."
"DOTA_Item_The_Spiritual_Spirits"	"Spirits o' th' Spirits"
"DOTA_Item_Desc_The_Spiritual_Spirits"	"A pretty spiritual piece o' loot t' enjoy while ye drink yer spirits up."
"DOTA_Item_Flail_of_the_Great_Elder"	"Flail o' th' Great Elder"
"DOTA_Item_Desc_Flail_of_the_Great_Elder"	"Th' rank o' Brewmaster be a prize o' combat. This ancient weapon goes hand-in-hand wit' th' rank."
"DOTA_Item_Crescent_Sickle_of_the_Druid"	"Crescent Sickle o' th' Bear Fleet"
"DOTA_Item_Desc_Crescent_Sickle_of_the_Druid"	"This sickle be a symbol an' ritualistic tool o' th' Bear Fleet, a bunch o' God-fearin' nutters which history has forgotten."
"DOTA_Item_Poor_Armor_of_the_Druid"	"Poor Armor o' th' Bear Fleet"
"DOTA_Item_Desc_Poor_Armor_of_the_Druid"	"Th' druids o' th' Bear Fleet were outcasts t' the' civilized world, simple sea dwellers an' ocean sailors. They had few use fer coin (that they didn't steal)."
"DOTA_Item_Shoulder_of_the_Noble"	"Shoulder o' th' Well-Off"
"DOTA_Item_Desc_Shoulder_of_the_Noble"	"Each nobleblood admiral o' th' Royal Ambry Navy bore these pauldrons as part o' their formal attire."
"DOTA_Item_Sange_and_Yasha"	"Sange an' Yasha"
"DOTA_Item_Spine_Sword"	"Spine Sword"
"DOTA_Item_Desc_Spine_Sword"	"Arr, where would we be in th' world without a stab in th' back now an' then? Some o' us might be alive."
"DOTA_Item_Vice_of_the_West"	"Vice o' th' West"
"DOTA_Item_Desc_Vice_of_the_West"	"Ach. Tastes like sour grapes. Not e'en close t' rum!"
"DOTA_Item_Mask_of_the_ManySighted"	"Mask o' th' Many-Sight'd"
"DOTA_Item_Desc_Mask_of_the_ManySighted"	"On th' Isle o' Masks, it be said death wear this mask, all th' eyes watchin' ev'rythin'. Bugger must get confused a lot."
"DOTA_Item_Lucky_Belly_Belt"	"Lucky Girdle"
"DOTA_Item_Desc_Lucky_Belly_Belt"	"Our Cap'n took a stroll one day wit' 'is lucky girdle. Found 'im dead an' 'is girdle gone. At least they left th' rum!"
"DOTA_Item_Champions_Belly_Belt"	"Champion's Belt o' th' Belly"
"DOTA_Item_Desc_Champions_Belly_Belt"	"Aggron says they ripped th' thing off th' belly o' a poor creature. Y'arr."
"DOTA_Item_Golden_Walrus_Whacker"	"Golden Whacker o' th' Walrus"
"DOTA_Item_Desc_Golden_Walrus_Whacker"	"If ye ask Aggron, they won it in a game o' fiver finger fillet. An' quite a fillet t'was, me says!"
"DOTA_Item_Cloak_of_the_Dawn"	"Cloak o' th' Mornin'"
"DOTA_Item_Desc_Cloak_of_the_Dawn"	"Th' Bear Fleet taught that ev'ry risin' sun were a gift, an' so promoted one o' 'em t' greet th' mornin' each day. Sounds like they drunk too much rum t' me!"
"DOTA_Item_Shoulders_of_the_Twelfth_Day"	"Shoulders o' th' Twelfth Wretch'd Day"
"DOTA_Item_Desc_Shoulders_of_the_Twelfth_Day"	"In th' custom o' th' Bear Fleet, each sailor must tie his newborn in a satchel on his shoulder fer eleven wretch'd days t' prove his might. On th' twelfth day, armor be bestow'd if th' baby perishes. "
"DOTA_Item_Recluse_Reef_Denizen"	"Recluse Reef Denizen"
"DOTA_Item_Desc_Recluse_Reef_Denizen"	"Recluse Reef be known fer treacherous currents, lacerating corals, an' barnacles big enough t' drag down a galleon. As such, most honest piratin' folk avoid these 'ere parts like th' plauge. But one denizen o' these waters glides o'er the evil waves wit' no fear: he was th' master o' Recluse Reef. Or rather, he was th' master...'til Th' Tidehunter needed a flail."
"DOTA_Item_Drodo_the_Druffin"	"Drodo th' Druffin'"
"DOTA_Item_Desc_Drodo_the_Druffin"	"Found on an oftcase isle in th' Samareen Sea, this species o' delicious bird has been all but wiped out by hungry sailors. Druffins lack th' sense that nature gives most creatures, but their limitless trust makes 'em good couriers, an' even greater snacks."
"DOTA_Item_Murrissey_the_Smeevil"	"Cap'n Murrissey's Smeevil"
"DOTA_Item_Desc_Murrissey_the_Smeevil"	"Now listen 'ere: it be rare t' chance upon a smeevil far from th' warmth o' th' forge t' which it be bound, as they thrive on th' cuffings an' curses o' their sworn smith. But th' lure o' a free tortoiceros ride compelled th' smeevil Murrissey t' break every oath."
"DOTA_Item_Lockjaw_the_Boxhound"	"Th' Walkin' Booty"
"DOTA_Item_Desc_Lockjaw_the_Boxhound"	"I 'ave no idea whar this came from. I jus' opened a chest an' this lil' bugger came 'round, lookin' happy at me. Won't leave me alone but it be good at carryin' me junk!"
"DOTA_Item_Treasure_Chest__Mythical"	"Treasure Chest - Fabulous"
"DOTA_Item_Treasure_of_Profound_Mysteries"	"Treasure o' Profound Mysteries"
"DOTA_Item_Pennant_QQ"	"QQ Pennant"
"DOTA_Item_Desc_Pennant_QQ"	"Team Pennant showcasin' support fer QQ"
"DOTA_Item_Pennant_Buren_Boys_Van"	"Buren Boys Van Pennant"
"DOTA_Item_Desc_Pennant_Buren_Boys_Van"	"Team Pennant showcasin' support fer Buren Boys Van"
"DOTA_Item_League_TheInternational"	"Th' International"
"DOTA_Item_Desc_League_TheInternational"	"Watch th' top 16 crews from across th' seas battle it out in Th' International."
"DOTA_Item_League_TheInternational_Admin"	"Th' International ADMIN"
"DOTA_Item_Desc_Pennant_Upgrade"	" "
"DOTA_Item_Strange_Modifier_Sven_DoubleStuns"	"Strange Modifier: Multi-Admiral Storm Hammers"
"DOTA_Item_Desc_Strange_Modifier_Sven_DoubleStuns"	"Addin' this 'ere Strange modifier t' a strange piece o' loot o' yer choice'll allow it t' track th' number o' Storm Hammers that hit at least two enemy Admirals while wearin' it as Sven."
"DOTA_Item_Strange_Modifier_Sven_WarcryAssists"	"Strange Modifier: Warcry Assists"
"DOTA_Item_Desc_Strange_Modifier_Sven_WarcryAssists"	"Addin' this 'ere Strange modifier t' a strange piece o' loot o' yer choice'll allow it t' track th' number o' enemy Admirals yer Warcry-buffed allies murder while wearin' it as Sven."
"DOTA_Item_Strange_Modifier_Sven_CleaveDoubleKills"	"Strange Modifier: Multi-Admiral Cleave Kills"
"DOTA_Item_Desc_Strange_Modifier_Sven_CleaveDoubleKills"	"Addin' this 'ere Strange modifier t' a strange piece o' loot o' yer choice'll allow it t' track th' number o' time a single Cleave murders multiple enemy Admirals while wearin' it as Sven."
"DOTA_Item_Strange_Modifier_Sven_TeleportInterrupts"	"Strange Modifier: Storm Hammer Teleport Interrupts"
"DOTA_Item_Desc_Strange_Modifier_Sven_TeleportInterrupts"	"Addin' this 'ere Strange modifier t' a strange piece o' loot o' yer choice'll allow it t' track th' number o' times yer Storm Hammer interrupts an enemy Admiral's teleport while wearin' it as Sven."
"DOTA_Bundle_Bloodseeker_Hlotl"	"Bloody Garb o' th' Seeker Set"
"DOTA_Bundle_Desc_Bloodseeker_Hlotl"	"Arr, 'as all th' loot needed t' craft th' \"Ritual Garb o' th' Seeker\" set fer Bloodseeker:"
"DOTA_Item_The_Iron_Bears_Set"	"The Iron Grizzly's Set"
"DOTA_Bundle_Desc_Ursa_Iron_Bear"	"Arr, 'as all th' loot needed t' craft 'Th' Iron Grizzly' set fer Ursa:"
"DOTA_Item_The_Ursine_Ravager_Set"	"Th' Ursine Ravager Set"
"DOTA_Bundle_Desc_Ursa_Ravager"	"Arr, 'as all th' loot needed t' craft 'Th' Ursine Ravager' set fer Ursa:"
"DOTA_Item_The_Savage_Age_Set"	"Th' Savage Era Set"
"DOTA_Bundle_Desc_Ursa_Savage_Age"	"Arr, 'as all th' loot needed t' craft 'Th' Savage Era' set fer Ursa:"
"DOTA_Item_The_Master_Assassin_Set"	"Th' Master Assassin Set"
"DOTA_Bundle_Desc_Bounty_Hunter_Master_Assassin"	"Arr, 'as all th' loot t' make yer own 'Th' Master Assassin' set fer Bounty Hunter:"
"DOTA_Item_The_Hierophants_Protection_Set"	"Th' Dead Prophet's Legacy Set"
"DOTA_Bundle_Desc_Omniknight_Hierophant"	"Arr, 'as all th' loot needed t' craft 'Th' Dead Prophet's Legacy' set fer Omniknight:"
"DOTA_Item_The_Bonehunter_Set"	"Th' Bonehunter Set"
"DOTA_Bundle_Desc_Bloodseeker_Bonehunter"	"Arr, 'as all th' loot needed t' craft yer own 'The Bonehunter' set fer Bloodseeker:"
"DOTA_Bundle_Bounty_Hunter_Big_Bundle"	"Bounty Hunter's Huge Haul"
"DOTA_Bundle_Desc_Bounty_Hunter_Big_Bundle"	"Includes each an' every bit o' loot fer Bounty Hunter released up t' August 2012:"
"DOTA_Bundle_Ursa_Big_Bundle"	"Ursa's Primal Pack"
"DOTA_Bundle_Desc_Ursa_Big_Bundle"	"Includes each an' every bit o' loot fer Ursa released up t' August 2012:"
"DOTA_WearableType_Sea_Beast"	"Sea Beast"
"DOTA_Item_Drows_Headwear"	"Drow's Headwear"
"DOTA_Item_Wyvernguard_Edge"	"Wyvernguard Edge"
"DOTA_Item_Desc_Wyvernguard_Edge"	"This ain't a weapon t' be choppin' logs wit'! Th' Wyvernguard Edge be a great-axe wit' th' bite o' a dragon. Like other common weaponry, it be forged from steel - but this were extracted from th' molten innards o' a dozen slaughtered Pyrexae. As such, some consider this chopper t' be a source o' ill luck. Whatever yer thoughts, ye cannot deny that th' blade o' Wyvernguard cuts right through th' heart o' any battle."
"DOTA_Item_Bow_of_the_Howling_Wind"	"Bow o' th' Howlin' Wind"
"DOTA_Item_Desc_Howling_Wind_Bow"	"In th' northernmost seas, the sun glows half-heartedly, leavin' vast mazes o' ice an' gut-wrenchin' chills fer brave seafarers t' bear. Most crews don't have what it takes t' survive out there - least o' all make a livin' - an' a lot o' good men continue t' lose their lives there. Out 'ere, yer a dead man walking should ye hear th' great white wolf summon an icy, howlin' wind. We get a few crews each year wantin' t' slay this wolf - nutters, the lot o' 'em! If ye believe in such things, only one weapon has a chance o' strikin' the beast down - an ancient bow hidden away, imbued wit' th' power o' the howlin' winds channel'd by th' wolf itself. Thing is, no-one cares about such a weapon - pirates prefer pistols!"
"DOTA_Item_Ice_Burst_Cloak"	"Cloak o' th' Frosty"
"DOTA_Item_Desc_Ice_Burst_Cloak"	"A cloak o' frostbitingly cold frost."
"DOTA_Item_Dolfrat_and_Roshinante"	"Dolfrat an' Roshinante"
"DOTA_Item_Desc_Dolfrat_and_Roshinante"	"\"How did I sail here?\" Such words o' wisdom be frequently utter'd by Dolfrat th' Sorcerer, wielder o' magick so grand that it eludes even his own mind. His foes often accuse him o' bein' a fraud, lackin' any magickal knowledge whatsoever, referrin' t' his most well-used incantation: \"Was it me who did that?\" Should ye ever spot th' mighty Dolfrat flat on his back in th' road, yer safe t' assume his trusty steed Roshinante be close--most likely gallopin' away from a creaky tree or some shadow resemblin' a demon o' nightmarish power."
"DOTA_Item_Braze_the_Zonkey"	"Braze th' Unnatural Zonkey"
"DOTA_Item_Desc_Braze_the_Zonkey"	"Some o' Admiral Pete's lads chanced upon Braze when they got lost one summer. They took him an' his herd and headed fer port - hopin' t' make a bit o' coin - but alas, it didn't end well fer 'em. They were plagued by howlin' winds, th' choppiest o' seas - horrible stuff. With th' ship wreck'd an' no crew t' care fer 'im, Braze wound up separated from his kin, forced to travel the land alone. One way or another he wound up here - where he stands out like a sore thumb. Fortuitously, he got no natural predators t' worry about - aside from hungry Admirals!"
"DOTA_Item_Pennant_DK"	"DK Pennant"
"DOTA_Item_Desc_Pennant_DK"	"Arr, rally yer mates an' show yer loyalty t' th' DK crew by acquirin' this 'ere Crew Pennant! Put it on yer 'fan slot' o' yer Loadout t' boast an' brag 'bout it t' other scallywags, showin' who ye rootin' fer. Ye can polish it t' make it extra shiny! An' if that ain't enough, ye can get all manner o' booty when ye got this on when ye witness th' International 2012, as well as other tourney's Valve holds in days t' come. Smash two DK pennants t' upgrade an' make 'em better lookin'. This'll boost th' fan value of a team when yer lookin' at a Tourney match."
"DOTA_Item_Pennant_LGD"	"LGD Pennant"
"DOTA_Item_Desc_Pennant_LGD"	"Arr, rally yer mates an' show yer loyalty t' th' LGD crew by acquirin' this 'ere Crew Pennant! Put it on yer 'fan slot' o' yer Loadout t' boast an' brag 'bout it t' other scallywags, showin' who ye rootin' fer. Ye can polish it t' make it extra shiny! An' if that ain't enough, ye can get all manner o' booty when ye got this on when ye witness th' International 2012, as well as other tourney's Valve holds in days t' come. Smash two LGD pennants t' upgrade an' make 'em better lookin'. This'll boost th' fan value of a team when yer lookin' at a Tourney match."
"DOTA_Item_Pennant_EHOME"	"EHOME Pennant"
"DOTA_Item_Desc_Pennant_EHOME"	"Arr, rally yer mates an' show yer loyalty t' th' EHOME crew by acquirin' this 'ere Crew Pennant! Put it on yer 'fan slot' o' yer Loadout t' boast an' brag 'bout it t' other scallywags, showin' who ye rootin' fer. Ye can polish it t' make it extra shiny! An' if that ain't enough, ye can get all manner o' booty when ye got this on when ye witness th' International 2012, as well as other tourney's Valve holds in days t' come. Smash two EHOME pennants t' upgrade an' make 'em better lookin'. This'll boost th' fan value of a team when yer lookin' at a Tourney match."
"DOTA_Item_Pennant_TongFu"	"TongFu Pennant"
"DOTA_Item_Desc_Pennant_TongFu"	"Arr, rally yer mates an' show yer loyalty t' th' TongFu crew by acquirin' this 'ere Crew Pennant! Put it on yer 'fan slot' o' yer Loadout t' boast an' brag 'bout it t' other scallywags, showin' who ye rootin' fer. Ye can polish it t' make it extra shiny! An' if that ain't enough, ye can get all manner o' booty when ye got this on when ye witness th' International 2012, as well as other tourney's Valve holds in days t' come. Smash two TongFu pennants t' upgrade an' make 'em better lookin'. This'll boost th' fan value of a team when yer lookin' at a Tourney match."
"DOTA_Item_Treasure_of_Champions"	"Treasure o' Champions"
"DOTA_Item_Desc_Treasure_Chest_International_2012"	"Ye be needin' an <font color='#9da1a9'>International Treasure Key</font> t' open this. Ye can acquire one at th' DOTA 2 Market. Th' cache will sink t' th' bottom o' th' ocean at th' end o' September 3rd, 2012. Th' unusual couriers from this type o' cache can only be found durin' th' International."
"DOTA_Item_Treasure_of_Challengers"	"Treasure o' Challengers"
"DOTA_Item_Pennant_Complexity"	"Complexity Pennant"
"DOTA_Item_Desc_Pennant_Complexity"	"Arr, rally yer mates an' show yer loyalty t' th' Complexity crew by acquirin' this 'ere Crew Pennant! Put it on yer 'fan slot' o' yer Loadout t' boast an' brag 'bout it t' other scallywags, showin' who ye rootin' fer. Ye can polish it t' make it extra shiny! An' if that ain't enough, ye can get all manner o' booty when ye got this on when ye witness th' International 2012, as well as other tourney's Valve holds in days t' come. Smash two Complexity pennants t' upgrade an' make 'em better lookin'. This'll boost th' fan value of a team when yer lookin' at a Tourney match."
"DOTA_Item_Pennant_MUFC"	"MUFC Pennant"
"DOTA_Item_Desc_Pennant_MUFC"	"Arr, rally yer mates an' show yer loyalty t' th' MUFC crew by acquirin' this 'ere Crew Pennant! Put it on yer 'fan slot' o' yer Loadout t' boast an' brag 'bout it t' other scallywags, showin' who ye rootin' fer. Ye can polish it t' make it extra shiny! An' if that ain't enough, ye can get all manner o' booty when ye got this on when ye witness th' International 2012, as well as other tourney's Valve holds in days t' come. Smash two MUFC pennants t' upgrade an' make 'em better lookin'. This'll boost th' fan value of a team when yer lookin' at a Tourney match."
"DOTA_Item_Pennant_mTw"	"mTw Pennant"
"DOTA_Item_Desc_Pennant_mTw"	"Arr, rally yer mates an' show yer loyalty t' th' mTw crew by acquirin' this 'ere Crew Pennant! Put it on yer 'fan slot' o' yer Loadout t' boast an' brag 'bout it t' other scallywags, showin' who ye rootin' fer. Ye can polish it t' make it extra shiny! An' if that ain't enough, ye can get all manner o' booty when ye got this on when ye witness th' International 2012, as well as other tourney's Valve holds in days t' come. Smash two mTw pennants t' upgrade an' make 'em better lookin'. This'll boost th' fan value of a team when yer lookin' at a Tourney match."
"DOTA_Item_Pennant_EG"	"Evil Geniuses Pennant"
"DOTA_Item_International_Treasure_Key"	"International Key"
"DOTA_Item_Desc_International_Treasure_Key"	"Used t' open both th' <font color='#9da1a9'>Treasure o' Champions</font> an' th' <font color='#9da1a9'>Treasure o' Challengers</font>.
Double jab or right-jab th' key in yer backpack an' pick th' chest ye wanna open up.
After th' end o' September 3rd, 2012 this'll become a normal key."
"DOTA_WearableType_Dagger"	"Shank"
"DOTA_Item_Death_Prophets_Hair"	"Death Prophet's Hair"
"DOTA_Item_Death_Prophets_Corset"	"Death Prophet's Corset"
"DOTA_Item_Pudges_Backrings"	"Pudge's Backrings"
"DOTA_Item_Pudges_Cleaver"	"Pudge's Cleaver"
"DOTA_Item_Pudges_Left_Arm"	"Pudge's Left Arm"
"DOTA_Item_Pudges_Bracer"	"Pudge's Bracer"
"DOTA_Item_Pudges_Toupee"	"Pudge's Oil'd Wig"
"DOTA_Item_Huskars_Spear"	"Huskar's Huntin' Spear"
"DOTA_Item_Huskars_Dagger"	"Huskar's Shank"
"DOTA_Item_Huskars_Helmet"	"Huskar's Helmet"
"DOTA_Item_Huskars_Shoulder"	"Huskar's Shoulder"
"DOTA_Item_Huskars_Bracer"	"Huskar's Armguard"
"DOTA_Item_Frost_Spikes_FIXUP_BUNDLE"	"Frost Spikes Bundle"
"DOTA_Item_Desc_Frost_Spikes_FIXUP_BUNDLE"	"Use this 'ere bundle t' unbox th' Frost Spikes an' Cloak o' th' Frosty loot. Formerly they were just one loot piece, but now they be two distinct treasures."
"DOTA_Item_Pennant_Mousesports"	"Mousesports Pennant"
"DOTA_Item_Desc_Pennant_Mousesports"	"Arr, rally yer mates an' show yer loyalty t' th' Mousesports crew by acquirin' this 'ere Crew Pennant! Put it on yer 'fan slot' o' yer Loadout t' boast an' brag 'bout it t' other scallywags, showin' who ye rootin' fer. Ye can polish it t' make it extra shiny! An' if that ain't enough, ye can get all manner o' booty when ye got this on when ye witness th' International 2012, as well as other tourney's Valve holds in days t' come. Smash two Mousesports pennants t' upgrade an' make 'em better lookin'. This'll boost th' fan value of a team when yer lookin' at a Tourney match."
"DOTA_Item_Pennant_NaVi"	"NaVi Pennant"
"DOTA_Item_Desc_Pennant_NaVi"	"Arr, rally yer mates an' show yer loyalty t' th' NaVi crew by acquirin' this 'ere Crew Pennant! Put it on yer 'fan slot' o' yer Loadout t' boast an' brag 'bout it t' other scallywags, showin' who ye rootin' fer. Ye can polish it t' make it extra shiny! An' if that ain't enough, ye can get all manner o' booty when ye got this on when ye witness th' International 2012, as well as other tourney's Valve holds in days t' come. Smash two NaVi pennants t' upgrade an' make 'em better lookin'. This'll boost th' fan value of a team when yer lookin' at a Tourney match."
"DOTA_Item_Pennant_CLG"	"CLG Pennant"
"DOTA_Item_Desc_Pennant_CLG"	"Arr, rally yer mates an' show yer loyalty t' th' CLG crew by acquirin' this 'ere Crew Pennant! Put it on yer 'fan slot' o' yer Loadout t' boast an' brag 'bout it t' other scallywags, showin' who ye rootin' fer. Ye can polish it t' make it extra shiny! An' if that ain't enough, ye can get all manner o' booty when ye got this on when ye witness th' International 2012, as well as other tourney's Valve holds in days t' come. Smash two CLG pennants t' upgrade an' make 'em better lookin'. This'll boost th' fan value of a team when yer lookin' at a Tourney match."
"DOTA_Item_Pennant_Zenith"	"Zenith Pennant"
"DOTA_Item_Desc_Pennant_Zenith"	"Arr, rally yer mates an' show yer loyalty t' th' Zenith crew by acquirin' this 'ere Crew Pennant! Put it on yer 'fan slot' o' yer Loadout t' boast an' brag 'bout it t' other scallywags, showin' who ye rootin' fer. Ye can polish it t' make it extra shiny! An' if that ain't enough, ye can get all manner o' booty when ye got this on when ye witness th' International 2012, as well as other tourney's Valve holds in days t' come. Smash two Zenith pennants t' upgrade an' make 'em better lookin'. This'll boost th' fan value of a team when yer lookin' at a Tourney match."
"DOTA_Item_Pennant_WE"	"WE Pennant"
"DOTA_Item_Desc_Pennant_WE"	"Arr, rally yer mates an' show yer loyalty t' th' World Elite crew by acquirin' this 'ere Crew Pennant! Put it on yer 'fan slot' o' yer Loadout t' boast an' brag 'bout it t' other scallywags, showin' who ye rootin' fer. Ye can polish it t' make it extra shiny! An' if that ain't enough, ye can get all manner o' booty when ye got this on when ye witness th' International 2012, as well as other tourney's Valve holds in days t' come. Smash two World Elite pennants t' upgrade an' make 'em better lookin'. This'll boost th' fan value of a team when yer lookin' at a Tourney match."
"DOTA_Item_Pennant_AL"	"AL Pennant"
"DOTA_Item_Desc_Pennant_AL"	"Arr, rally yer mates an' show yer loyalty t' th' Absolute Legends crew by acquirin' this 'ere Crew Pennant! Put it on yer 'fan slot' o' yer Loadout t' boast an' brag 'bout it t' other scallywags, showin' who ye rootin' fer. Ye can polish it t' make it extra shiny! An' if that ain't enough, ye can get all manner o' booty when ye got this on when ye witness th' International 2012, as well as other tourney's Valve holds in days t' come. Smash two Absolute Legends pennants t' upgrade an' make 'em better lookin'. This'll boost th' fan value of a team when yer lookin' at a Tourney match."
"DOTA_Item_Pennant_iG"	"iG Pennant"
"DOTA_Item_Desc_Pennant_iG"	"Arr, rally yer mates an' show yer loyalty t' th' Invictus Gaming crew by acquirin' this 'ere Crew Pennant! Put it on yer 'fan slot' o' yer Loadout t' boast an' brag 'bout it t' other scallywags, showin' who ye rootin' fer. Ye can polish it t' make it extra shiny! An' if that ain't enough, ye can get all manner o' booty when ye got this on when ye witness th' International 2012, as well as other tourney's Valve holds in days t' come. Smash two Invictus Gaming pennants t' upgrade an' make 'em better lookin'. This'll boost th' fan value of a team when yer lookin' at a Tourney match."
"DOTA_Item_Pennant_Orange"	"Orange Pennant"
"DOTA_Item_Desc_Pennant_Orange"	"Arr, rally yer mates an' show yer loyalty t' th' Orange crew by acquirin' this 'ere Crew Pennant! Put it on yer 'fan slot' o' yer Loadout t' boast an' brag 'bout it t' other scallywags, showin' who ye rootin' fer. Ye can polish it t' make it extra shiny! An' if that ain't enough, ye can get all manner o' booty when ye got this on when ye witness th' International 2012, as well as other tourney's Valve holds in days t' come. Smash two Orange pennants t' upgrade an' make 'em better lookin'. This'll boost th' fan value of a team when yer lookin' at a Tourney match."
"DOTA_Item_Pennant_Darer"	"Darer Pennant"
"DOTA_Item_Desc_Pennant_Darer"	"Arr, rally yer mates an' show yer loyalty t' th' Darer crew by acquirin' this 'ere Crew Pennant! Put it on yer 'fan slot' o' yer Loadout t' boast an' brag 'bout it t' other scallywags, showin' who ye rootin' fer. Ye can polish it t' make it extra shiny! An' if that ain't enough, ye can get all manner o' booty when ye got this on when ye witness th' International 2012, as well as other tourney's Valve holds in days t' come. Smash two Darer pennants t' upgrade an' make 'em better lookin'. This'll boost th' fan value of a team when yer lookin' at a Tourney match."
"DOTA_WearableType_LeagueViewPass_Admin"	"
"
"DOTA_Item_Desc_Copy_of_Crystal_Maidens_Cape"	"
"
"DOTA_Item_Desc_Copy_of_Naga_Sirens_Sword"	"Arr, this 'ere loot ain't described or nothin'."
"DOTA_Item_Desc_Copy_of_Rikis_Dagger"	"
"
"DOTA_Item_Pauldrons_of_Polymorphia"	"Pauldrons o' Polymorphia"
"DOTA_Item_Hammer_of_Enlightenment"	"Hammer o' Enlightenment"
"DOTA_Item_Bow_of_the_Sun_Vine"	"Bow o' th' Sun Vine"
"DOTA_Item_Cape_of_the_Drake"	"Cape o' th' Drake"
"DOTA_Item_Armor_of_the_Drake"	"Armor o' th' Drake"
"DOTA_Item_Helmet_of_the_Drake"	"Helmet o' th' Drake"
"DOTA_Item_slaughterhouse_chains"	"slaughterhouse_chains"
"DOTA_Item_Bow_of_the_Searing_Soul"	"Bow o' th' Searing Soul"
"DOTA_Item_Desc_the_evildoer"	"Arr, this 'ere loot ain't described or nothin'."
"DOTA_Item_Bones_of_the_Bludgeoned"	"Bones o' th' Bludgeoned"
"DOTA_Item_Desc_Copy_of_Hair_of_the_Dark_Magic"	"
"
"DOTA_Item_Desc_Copy_of_Cape_of_the_Dark_Magic"	"
"
"DOTA_Item_Desc_Copy_of_Bracers_of_the_Dark_Magic"	"
"
"DOTA_Item_Greevil"	"Greevil"
"DOTA_Item_League_PremierLeague_Admin"	"
"
"DOTA_Bundle_Desc_Axe_Heavy_Steel_Armor_Set"	"
"
"DOTA_WearableType_Essence"	"Essence"
"DOTA_Item_AntiMages_Glaive"	"Anti-Mage's Glaive"
"DOTA_Item_Doombringers_Belt"	"Doombringer's Belt"
"DOTA_Item_AntiMages_Offhand_Glaive"	"Anti-Mage's Offhand Glaive"
"DOTA_Item_Desc_Copy_of_AntiMages_Glaive"	"
"
"DOTA_Item_Leshracs_Arms"	"Leshrac's Arms"
"DOTA_Item_Nightstalkers_Wings"	"Nightstalker's Wings"
"DOTA_Item_Nightstalkers_Armor"	"Nightstalker's Armor"
"DOTA_Item_Desc_Copy_of_Nightstalkers_Wings"	"Arr, this 'ere loot ain't described or nothin'."
"DOTA_Item_Desc_Copy_of_Nightstalkers_Armor"	"Arr, this 'ere loot ain't described or nothin'."
"DOTA_Item_Razors_Weapon"	"Razor's Weapon"
"DOTA_Item_Razors_Head"	"Razor's Head"
"DOTA_Item_Razors_Armor"	"Razor's Armor"
"DOTA_Item_Razors_Bracers"	"Razor's Bracers"
"DOTA_Item_Razors_Robe"	"Razor's Robe"
"DOTA_Item_Leshracs_Armor"	"Leshrac's Armor"
"DOTA_Item_Leshracs_Head"	"Leshrac's Noggin'"
"DOTA_Item_Leshracs_Tail"	"Leshrac's Tail"
"DOTA_Item_Baby_Roshan"	"Baby Roshan"
"DOTA_Item_League_G1Championship"	"G-1 Championship League"
"DOTA_Item_League_G1Championship_Admin"	"G-1 Championship League CAPTAIN"
"DOTA_Item_Desc_Copy_of_Dark_Seers_Hat"	"Arr, this 'ere loot ain't described or nothin'."
"DOTA_Item_Desc_Copy_of_Dark_Seers_Loin_Cloth"	"Arr, this 'ere loot ain't described or nothin'."
"DOTA_Item_Desc_Copy_of_Slarks_Weapon"	"Arr, this 'ere loot ain't described or nothin'."
"DOTA_Item_Desc_Copy_of_Slarks_Bracers"	"Arr, this 'ere loot ain't described or nothin'."
"DOTA_Item_Desc_Copy_of_Slarks_Shoulder_Armor"	"Arr, this 'ere loot ain't described or nothin'."
"DOTA_Item_Kunkkas_Shoulder_Guard"	"Kunkka's Shoulder Guard"
"DOTA_Item_Desc_Copy_of_Kunkkas_Spyglass"	"
"
"DOTA_Item_Centaurs_Axe"	"Centaur's Axe"
"DOTA_Item_Desc_Copy_of_Centaurs_Axe"	"Arr, this 'ere loot ain't described or nothin'."
"DOTA_Item_Desc_Copy_of_Centaurs_Pride"	"Arr, this 'ere loot ain't described or nothin'."
"DOTA_Item_Desc_Copy_of_Centaurs_Upper_Armor"	"Arr, this 'ere loot ain't described or nothin'."
"DOTA_Item_Desc_Copy_of_Centaurs_Belt_Buckle"	"Arr, this 'ere loot ain't described or nothin'."
"DOTA_Item_Desc_Copy_of_Centaurs_Trophies"	"Arr, this 'ere loot ain't described or nothin'."
"DOTA_Item_Desc_Copy_of_Centaurs_Bracers"	"Arr, this 'ere loot ain't described or nothin'."
"DOTA_Item_Desc_Greevil_Nose_1"	"
"
"DOTA_Item_Desc_Copy_of_Lions_Default_Weapon"	"Arr, this 'ere loot ain't described or nothin'."
"DOTA_Item_Desc_Copy_of_Lions_Default_cape"	"Arr, this 'ere loot ain't described or nothin'."
"DOTA_Item_Desc_Copy_of_Lions_Default_Hat"	"Arr, this 'ere loot ain't described or nothin'."
"DOTA_Item_Desc_Copy_of_Lions_Default_Shoulders"	"Arr, this 'ere loot ain't described or nothin'."
"DOTA_Item_Pucks_Wings"	"Puck's Flappers"
"DOTA_Item_Pucks_Tail"	"Puck's Tail"
"DOTA_Item_Desc_Copy_of_Pucks_Wings"	"Arr, this 'ere loot ain't described or nothin'."
"DOTA_Item_Pucks_Antennas"	"Puck's Antennas"
"DOTA_Item_Desc_Copy_of_Pucks_Tail"	"Arr, this 'ere loot ain't described or nothin'."
"DOTA_Item_Desc_base_off_hand_ranged_weapon"	"Arr, this 'ere loot ain't described or nothin'."
"DOTA_Item_Batriders_Head"	"Batrider's Head"
"DOTA_Item_Batriders_Cloak"	"Batrider's Cloak"
"DOTA_Item_Batriders_Belt"	"Batrider's Sash"
"DOTA_Item_troll_warlord_base_weapon_melee"	"
"
"DOTA_Item_troll_warlord_off_hand_base_weapon_melee"	"
"
"DOTA_Item_League_atoD2"	"atoD 2"
"DOTA_Item_troll_warlord_axe_melee_r"	"troll_warlord_axe_melee_r"
"DOTA_Item_troll_warlord_axe_melee_l"	"troll_warlord_axe_melee_l"
"DOTA_WearableType_Courier"	"Courier"
"DOTA_Item_Medusas_Bow"	"Medusa's Bow"
"DOTA_Item_Medusas_Veil"	"Medusa's Veil"
"DOTA_Item_Desc_Copy_of_Medusas_Bow"	"Arr, this 'ere loot ain't described or nothin'."
"DOTA_Item_Desc_Copy_of_Medusas_Veil"	"Arr, this 'ere loot ain't described or nothin'."
"DOTA_Item_Medusas_Bracers"	"Medusa's Bracers"
"DOTA_Item_Desc_Copy_of_Medusas_Chest_Armor"	"Arr, this 'ere loot ain't described or nothin'."
"DOTA_Item_Medusas_Tail"	"Medusa's Tail"
"DOTA_Item_Desc_Copy_of_Medusas_Bracers"	"Arr, this 'ere loot ain't described or nothin'."
"DOTA_Item_Desc_Copy_of_Shredder_Drivers_Hat"	"Arr, this 'ere loot ain't described or nothin'."
"DOTA_Item_Desc_Copy_of_Shredders_Claw"	"Arr, this 'ere loot ain't described or nothin'."
"DOTA_Item_Desc_Copy_of_Shredders_Chainsaw"	"Arr, this 'ere loot ain't described or nothin'."
"DOTA_Item_Desc_Copy_of_Shredders_Shoulder_Armor"	"Arr, this 'ere loot ain't described or nothin'."
"DOTA_Item_Desc_Copy_of_Undyings_Bracer"	"Arr, this 'ere loot ain't described or nothin'."
"DOTA_Item_Desc_Copy_of_Undyings_Helmet"	"Arr, this 'ere loot ain't described or nothin'."
"DOTA_Item_Desc_Copy_of_Undyings_Armor"	"Arr, this 'ere loot ain't described or nothin'."
"DOTA_Item_Diretide"	"Diretide"
"DOTA_Item_Desc_Copy_of_Shadow_Demons_Cape"	"Arr, this 'ere loot ain't described or nothin'."
"DOTA_Item_Desc_Copy_of_Shadow_Demons_Armor"	"Arr, this 'ere loot ain't described or nothin'."
"DOTA_Item_Desc_Copy_of_Shadow_Demons_Belt"	"Arr, this 'ere loot ain't described or nothin'."
"DOTA_Item_dazzle_yuwipi_weapon"	"dazzle_yuwipi_weapon"
"DOTA_Item_Dota_2_The_Asia"	"Dota 2 The Asia"
"DOTA_Item_GLeague_2012"	"G-League 2012"
"DOTA_Item_Miranas_Bow"	"Mirana's Bow"
"DOTA_Item_Desc_Copy_of_Miranas_Bow"	"Arr, this 'ere loot ain't described or nothin'."
"DOTA_Item_Miranas_Headdress"	"Mirana's Headdress"
"DOTA_Item_Desc_Copy_of_Miranas_Mount"	"Arr, this 'ere loot ain't described or nothin'."
"DOTA_Item_Miranas_Cape"	"Mirana's Cape"
"DOTA_Item_Desc_Copy_of_Miranas_Headdress"	"Arr, this 'ere loot ain't described or nothin'."
"DOTA_Item_Desc_Copy_of_Miranas_Cape"	"Arr, this 'ere loot ain't described or nothin'."
"DOTA_Item_Miranas_Bracers"	"Mirana's Bracers"
"DOTA_Item_Desc_Copy_of_Miranas_Shoulders"	"Arr, this 'ere loot ain't described or nothin'."
"DOTA_Item_Miranas_Quiver"	"Mirana's Quiver"
"DOTA_Item_Desc_Copy_of_Miranas_Bracers"	"Arr, this 'ere loot ain't described or nothin'."
"DOTA_Item_troll_warlord_base_shoulders"	"troll_warlord_base_shoulders"
"DOTA_Item_troll_warlord_base_head"	"troll_warlord_base_head"
"DOTA_Item_troll_warlord_base_arms"	"troll_warlord_base_arms"
"DOTA_Item_SEA_League"	"SEA League"
"DOTA_Set_warlock_archivist"	"warlock_archivist"
"DOTA_Item_Desc_Copy_of_Snipers_Weapon"	"Arr, this 'ere loot ain't described or nothin'."
"DOTA_Item_Desc_Copy_of_Snipers_Cape"	"Arr, this 'ere loot ain't described or nothin'."
"DOTA_Item_Desc_Copy_of_Snipers_Head_Gear"	"Arr, this 'ere loot ain't described or nothin'."
"DOTA_Item_Desc_Copy_of_Snipers_Shoulder_Armor"	"Arr, this 'ere loot ain't described or nothin'."
"DOTA_Item_Desc_Copy_of_Enchantress_Necklace"	"Arr, this 'ere loot ain't described or nothin'."
"DOTA_Item_Desc_Copy_of_Enchantress_Hair"	"Arr, this 'ere loot ain't described or nothin'."
"DOTA_Item_Desc_Copy_of_Enchantress_Dress"	"Arr, this 'ere loot ain't described or nothin'."
"DOTA_Item_Desc_Copy_of_Enchantress_Bracers"	"Arr, this 'ere loot ain't described or nothin'."
"DOTA_Item_Desc_venomancers_mandibles"	"Arr, this 'ere loot ain't described or nothin'."
"DOTA_Item_Desc_Copy_of_venomancers_mandibles"	"Arr, this 'ere loot ain't described or nothin'."
"DOTA_Item_Desc_Venomancers_Limbs"	"Arr, this 'ere loot ain't described or nothin'."
"DOTA_Item_Desc_Copy_of_Venomancers_Limbs"	"Arr, this 'ere loot ain't described or nothin'."
"DOTA_Item_Desc_Copy_of_Venomancers_Tail"	"Arr, this 'ere loot ain't described or nothin'."
"DOTA_Item_Desc_Copy_of_Meepos_Weapon"	"Arr, this 'ere loot ain't described or nothin'."
"DOTA_Item_Desc_Copy_of_Meepos_Hood"	"Arr, this 'ere loot ain't described or nothin'."
"DOTA_Item_Desc_Copy_of_Meepos_Backpack"	"Arr, this 'ere loot ain't described or nothin'."
"DOTA_Item_Meepos_Bracers"	"Meepo's Bracers"
"DOTA_Item_Desc_Copy_of_Meepos_Shoulderpads"	"Arr, this 'ere loot ain't described or nothin'."
"DOTA_Item_Meepos_Tail"	"Meepo's Tail"
"DOTA_Item_Desc_Copy_of_Meepos_Bracers"	"Arr, this 'ere loot ain't described or nothin'."
"DOTA_Item_deserts_deathly_embrace_head"	"deserts_deathly_embrace_head"
"DOTA_Item_Belt_of_Yoskreth"	"Belt o' Yoskreth"
"DOTA_Item_Bracers_of_Yoskreth"	"Bracers o' Yoskreth"
"DOTA_Item_Desc_Warlock_Ward"	"
"
"DOTA_Item_Rubicks_Head"	"Rubick's Head"
"DOTA_WearableType_Spaulders"	"Spaulders"
"DOTA_Item_Desc_Copy_of_bristelback_weapon"	"Arr, this 'ere loot ain't described or nothin'."
"DOTA_Item_Desc_Copy_of_bristelback_back"	"Arr, this 'ere loot ain't described or nothin'."
"DOTA_Item_Desc_Copy_of_bristelback_bracer"	"Arr, this 'ere loot ain't described or nothin'."
"DOTA_Item_Desc_Copy_of_bristelback_head"	"Arr, this 'ere loot ain't described or nothin'."
"DOTA_Item_Desc_Copy_of_Vengeful_Wings"	"Arr, this 'ere loot ain't described or nothin'."
"DOTA_Item_Desc_Copy_of_Vengeful_Skirt"	"Arr, this 'ere loot ain't described or nothin'."
"DOTA_Item_Desc_Copy_of_Vengeful_Bracers"	"Arr, this 'ere loot ain't described or nothin'."
"DOTA_Item_Desc_Copy_of_Vengeful_Shoulders"	"Arr, this 'ere loot ain't described or nothin'."
"DOTA_Item_Desc_Copy_of_Vengeful_Hair"	"Arr, this 'ere loot ain't described or nothin'."
"DOTA_Item_Desc_Copy_of_Vengeful_Weapon"	"Arr, this 'ere loot ain't described or nothin'."
"DOTA_Item_Desc_Copy_of_Lunas_Helmet"	"Arr, this 'ere loot ain't described or nothin'."
"DOTA_Item_Desc_Copy_of_Lunas_Mount"	"Arr, this 'ere loot ain't described or nothin'."
"DOTA_Item_Desc_Copy_of_Lunas_Shield"	"Arr, this 'ere loot ain't described or nothin'."
"DOTA_Item_Desc_Copy_of_Lunas_Weapon"	"Arr, this 'ere loot ain't described or nothin'."
"DOTA_Item_Desc_Copy_of_Abaddons_Cape"	"Arr, this 'ere loot ain't described or nothin'."
"DOTA_Item_Desc_Copy_of_Abaddons_Helmet"	"Arr, this 'ere loot ain't described or nothin'."
"DOTA_Item_Desc_Copy_of_Abaddons_Shoulder_Armor"	"Arr, this 'ere loot ain't described or nothin'."
"DOTA_Item_Desc_Copy_of_Abaddons_Weapon"	"Arr, this 'ere loot ain't described or nothin'."
"DOTA_Item_Desc_Copy_of_Earthshakers_Bracers"	"Arr, this 'ere loot ain't described or nothin'."
"DOTA_Item_Desc_Copy_of_Earthshakers_Totem"	"Arr, this 'ere loot ain't described or nothin'."
"DOTA_Item_Desc_Bloodstone_Blade"	" 
"
"DOTA_Item_Desc_Bloodstone_Blade__OffHand"	" 
"
"DOTA_Item_Desc_Crown_of_Omoz"	" 
"
"DOTA_Item_Desc_Dark_Tracer"	" 
"
"DOTA_Item_Desc_Demonic_Collar"	" 
"
"DOTA_Item_Desc_Demonshard"	" 
"
"DOTA_Item_Desc_Dorsal_Doom"	" 
"
"DOTA_Item_Desc_Hook_of_the_Sorrowful_Prey"	" 

"
"DOTA_Item_Desc_Icewrack_Pack"	" 
"
"DOTA_Item_Desc_Lighted_Scepter_of_Serendipity"	" 
"
"DOTA_Item_Desc_Mantle_of_the_Crystalline_Queen"	" 
"
"DOTA_Item_Desc_Monarch"	" 
"
"DOTA_Item_Desc_Mr_Depth_Driller"	" 
"
"DOTA_Item_Desc_Sanurok_the_Ever_Able"	" 
"
"DOTA_Item_Desc_Spell_Devourer"	" 
"
"DOTA_Item_Desc_The_Elder_Shield"	" 
"
"DOTA_Item_Desc_The_Torchbearer"	" 
"
"DOTA_Item_Desc_Tiara_of_the_Crystalline_Queen"	" 
"
"DOTA_Item_SDL_1"	"SDL 1"
"DOTA_Item_Dota_2_Romania_IV"	"Dota 2 Romania IV"
"DOTA_Item_League_of_Dota"	"League of Dota"
"DOTA_Item_Desc_Hallowed_Horde"	" 
"
"DOTA_Item_Prodota_Winter_Cup"	"Prodota Winter Cup"
}
}
