"lang"
{
"Language"	"vietnamese"
"Tokens"
{
"DOTA_Item"	"Mặc được"
"DOTA_Custom_Courier"	"Thú vận chuyển"
"DOTA_TreasureChest_Type"	"Kho báu"
"DOTA_FacelessVoid_Default_Weapon"	"Vũ Khí Của Faceless Void"
"DOTA_Wearable_Sven_DefaultHead"	"Mặt nạ Sven"
"DOTA_Wearable_Sven_DefaultBelt"	"Đai lưng Sven"
"DOTA_Wearable_Sven_DefaultGauntlet"	"Găng tay Sven"
"DOTA_Wearable_Sven_DefaultShoulder"	"Giáp vai Sven"
"DOTA_Item_Clinkz_Bow"	"Cung Tên Của Clinkz"
"DOTA_Item_Clinkz_Horns"	"Sừng Của Clinkz"
"DOTA_Item_Clinkz_Gloves"	"Bao Tay Của Clinkz"
"DOTA_Item_Ogremagis_Weapon"	"Vũ Khí của Ogremagi"
"DOTA_Item_Alchemists_Goblin_Body"	"Thân Goblin của Alchemist"
"DOTA_Item_Alchemists_Weapon"	"Vũ khí của Alchemist"
"DOTA_Item_Alchemists_Saddle"	"Yên của Alchemist"
"DOTA_Item_Alchemists_Gauntlet"	"Găng tay của Alchemist"
"DOTA_Item_Alchemists_Goblin_Hat"	"Mũ Goblin của Alchemist"
"DOTA_Item_Alchemists_Left_Bottle"	"Chai Bên Trái của Alchemist"
"DOTA_Item_Alchemists_Goblin_Head"	"Đầu Goblin của Alchemist"
"DOTA_Item_Alchemists_Ogre_Head"	"Đầu Ogre của Alchemist"
"DOTA_Item_Alchemists_Shoulder_Bottle"	"Chai Bên Vai của Alchemist"
"DOTA_AnimTaunt_SniperTaunt_Desc"	"Chúc mừng một đòn hạ thủ ngọt ngào hoặc chiến thắng lớn bằng cách thể hiện sự vui mừng của bạn với quân địch. Hắn không bận tâm đâu."
"DOTA_AnimTaunt_CM_Snowball_Desc"	"Crystal Maiden ném một nắm tuyết!"
"DOTA_AnimTaunt_Jakiro_Roar_Desc"	"Jakiro Roar Taunt"
"DOTA_AnimTaunt_Jakiro_Icemelt_Desc"	"Jakiro Icemelt Taunt"
"DOTA_Item_100Proof_Jug"	"100-Proof Jug"
"DOTA_Item_Alpine_Stalkers_Scarf"	"Alpine Stalker's Scarf"
"DOTA_Item_Alpine_Stalkers_Pants"	"Alpine Stalker's Pants"
"DOTA_Item_Alpine_Stalkers_Gloves"	"Alpine Stalker's Gloves"
"DOTA_Item_75_Battle_Point_Booster_3_Days"	"Tăng 75% điểm trận đấu (3 Ngày)"
"DOTA_Item_Desc_75_Battle_Bonus_3_Days"	"Sử dụng vật phẩm này để tăng mức thưởng <font color='#9da1a9'>Điểm chiến đấu</font> lên <font color='#9da1a9'>75%</font> trong 3 ngày. Thêm vào đó, bạn còn cung cấp cho những người chơi trong trận đấu thêm <font color='#9da1a9'>15%</font> cộng dồn vào mức thưởng <font color='#9da1a9'>Điểm chiến đấu</font> của họ."
"DOTA_Item_75_Battle_Point_Booster_6_Days"	"Tăng 75% điểm trận đấu (6 Ngày)"
"DOTA_Item_Desc_75_Battle_Bonus_6_Days"	"Sử dụng vật phẩm này để tăng mức thưởng <font color='#9da1a9'>Điểm chiến đấu</font> lên <font color='#9da1a9'>75%</font> trong 6 ngày. Thêm vào đó, bạn còn cung cấp cho những người chơi trong trận đấu thêm <font color='#9da1a9'>15%</font> cộng dồn vào mức thưởng <font color='#9da1a9'>Điểm chiến đấu</font> của họ."
"DOTA_Bundle_Desc_Juggernaut_Ivory_Ebony"	"Bao gồm tất cả trang bị trong bộ 'Of Ebony and Ivory' dành cho Juggernaut:"
"DOTA_Bundle_Desc_Witch_Doctor_Wicked_Bad_Voodoo"	"Bao gồm tất cả các trang bị trong bộ 'Wicked Bad Voodoo' dành cho Witch Doctor:"
"DOTA_Bundle_Desc_Axe_Demon_Blood"	"Bao gồm tất cả các trang bị trong bộ 'Forged in Demons Blood' dành cho Axe:"
"DOTA_Bundle_Desc_Axe_Defiant"	"Bao gồm tất cả các trang bị trong bộ 'Defiant Axe' dành cho Axe:"
"DOTA_Bundle_Desc_Natures_Prophet_Forest_Lord"	"Bao gồm tất cả trang bị trong bộ 'Regal Forest Lord' dành cho Nature's Prophet:"
"DOTA_Bundle_Desc_Juggernaut_Boar_God"	"Bao gồm tất cả trang bị trong bộ 'The Boar God's Honor' dành cho Juggernaut:"
"DOTA_Bundle_Desc_Juggernaut_Beasts_Man"	"Bao gồm tất cả trang bị trong bộ 'Aspects of Beast and Man' dành cho Juggernaut:"
"DOTA_Bundle_Desc_Juggernaut_High_Plains"	"Bao gồm tất cả trang bị trong bộ 'Traveler on the High Plains' dành cho Juggernaut:"
"DOTA_Bundle_Desc_Natures_Prophet_Scion_Savage"	"Bao gồm tất cả trang bị trong bộ 'Scion of the Savage' dành cho Nature's Prophet:"
"DOTA_Bundle_Desc_Natures_Prophet_Heartwood_Vanguard"	"Bao gồm tất cả trang bị trong bộ 'Heartwood Vanguard' dành cho Nature's Prophet:"
"DOTA_Bundle_Desc_Natures_Prophet_Peace_Bringer"	"Bao gồm tất cả trang bị trong bộ 'Garments of the Peace-Bringer' dành cho Nature's Prophet:"
"DOTA_Bundle_Desc_Natures_Prophet_Beast_Bole"	"Bao gồm tất cả trang bị trong bộ 'Master of Beast and Bole' dành cho Narute's Prophet:"
"DOTA_Bundle_Desc_Axe_Berserker"	"Bao gồm tất cả các trang bị trong bộ 'The Berserker's Blood' dành cho Axe:"
"DOTA_Bundle_Desc_Axe_Forgemaster"	"Bao gồm tất cả các trang bị trong bộ 'The Forgemaster's Tools' dành cho Axe:"
"DOTA_Bundle_Desc_Axe_Axecutioner"	"Bao gồm tất cả các món đồ trong bộ 'The Axecutioner' của Axe:"
"DOTA_Bundle_Desc_Sven_Swordmaster"	"Bao gồm tất cả các trang bị trong bộ 'Swordmaster of the Vigil' dành cho Sven:"
"DOTA_Bundle_Desc_Sven_Freelancer"	"Bao gồm tất cả trang bị của bộ 'The Freelancer's Finery' dành cho Sven:"
"DOTA_Bundle_Desc_Sven_Mono_Militis"	"Bao gồm tất cả trang bị của bộ 'Sect Armor of the Mono Militis' dành cho Sven:"
"DOTA_Bundle_Desc_Sven_Flameguard"	"Bao gồm tất cả trang bị của bộ 'Sect Armor of the Flamegaurd' dành cho Sven:"
"DOTA_Bundle_Desc_Tidehunter_Pirate_Slayer"	"Bao gồm tất cả các trang bị trong bộ 'The Pirate's Booty' dành cho Tidehunter:"
"DOTA_Bundle_Desc_Tidehunter_Punisher"	"Bao gồm tất cả các trang bị trong bộ 'The Paleogeneous Punisher' dành cho Tidehunter:"
"DOTA_Bundle_Desc_Kunkka_Admirable_Admiral"	"Bao gồm tất cả trang bị trong bộ 'The Admirable Admiral' dành cho Kunkka:"
"DOTA_Bundle_Desc_Dragon_Knight_Uldorak"	"Bao gồm tất cả các trang bị trong bộ 'Uldorak's Hide' dành cho Dragon Knight:"
"DOTA_Bundle_Desc_Omniknight_Crusader"	"Bao gồm tất cả trang bị trong bộ 'The Radiance of the Crusade' dành cho Omniknight:"
"DOTA_Bundle_Desc_Invoker_Exort"	"Bao gồm tất cả trang bị trong bộ 'The Fires of Exort' dành cho Invoker:"
"DOTA_Bundle_DOTA2_Access"	"Giấy mời Dota 2"
"DOTA_Bundle_Desc_DOTA2_Access"	"Hãy truy cập Dota 2 và bắt đầu chơi ngay bây giờ!
Gói quà này bao gồm một thú vận chuyển Mighty Boar, và một bộ đầy đủ các trang dành cho Sven, Juggernaut, và Witch Doctor. Dota 2 hiện chỉ phát hành trên PC."
"DOTA_Bundle_Desc_Drow_Ranger_Spikes_Frost"	"Bao gồm tất cả các trang bị trong bộ 'Spikes of Frost' dành cho Drow Ranger:"
"DOTA_Bundle_Desc_Bounty_Hunter_Pangolin"	"Bao gồm tất cả trang bị trong bộ 'Trappings of the Pangolin Guild' dành cho Bounty Hunter:"
"DOTA_Bundle_Collection_of_Couriers_Pack"	"Bộ sưu tập thú vận chuyển"
"DOTA_Bundle_Desc_Collection_of_Couriers_Pack"	"Bao gồm thú vận chuyển dễ thương và đáng yêu sau:"
"DOTA_Bundle_Assemblage_of_Announcers_Pack"	"Bộ Sưu Tập Announcers"
"DOTA_Bundle_Desc_Assemblage_of_Announcers_Pack"	"Bao gồm những loa phát thanh vui nhộn và cuốn hút sau đây:"
"DOTA_Item_Brewmasters_Staff"	"Quyền Trượng Của Brewmaster"
"DOTA_Item_Brewmasters_Barrel"	"Thùng Rượu của Brewmaster"
"DOTA_Item_Brewmasters_Backpack"	"Hành Trang Của Brewmaster"
"DOTA_Bundle_Desc_Juggernaut_Dauntless"	"Bao gồm tất cả trang bị trong bộ 'The Dauntless' dành cho Juggernaut:"
"DOTA_Bundle_Desc_Axe_Blood_Mist"	"Bao gồm tất cả các trang bị trong bộ 'Bloodmist Armor' dành cho Axe:"
"DOTA_Bundle_Desc_Dragon_Knight_Davion"	"Bao gồm tất cả trang bị trong bộ 'Armor of Sir Davion' dành cho Dragon Knight:"
"DOTA_Bundle_Desc_Omniknight_Purist_Champion"	"Bao gồm tất cả trang bị trong bộ 'Armor of the Purist Champion' dành cho Omniknight:"
"DOTA_Bundle_Desc_Witch_Doctor_Tale_Teller"	"Bao gồm tất cả các trang bị trong bộ 'Traveling Tale-Teller' dành cho Witch Doctor:"
"DOTA_Bundle_Desc_Bounty_Hunter_Hardened"	"Bao gồm tất cả trang bị trong bộ 'Hardened Hunter's Gear' dành cho Bounty Hunter:"
"DOTA_Bundle_Desc_Morphling_Radiant_Crystal"	"Bao gồm tất cả trang bị trong bộ 'Radiant Crystal Binding' dành cho Morphling:"
"DOTA_Bundle_Desc_Invoker_Magnus"	"Bao gồm tất cả trang bị trong bộ 'Magnus Magnus' dành cho Invoker:"
"DOTA_Bundle_Summer_2012"	"Bộ Sithil's Summer"
"DOTA_Bundle_Desc_Summer_2012"	"Bao gồm một gói lớn gồm 47 vật phẩm mới:"
"DOTA_Item_AntiMages_Head"	"Đầu của Anti-Mage"
"DOTA_Item_AntiMages_Belt"	"Dây nịch của Anti-Mage"
"DOTA_Item_Chens_Staff"	"Quyền Trượng Của Chen"
"DOTA_Bundle_Desc_Bloodseeker_Hlotl"	"Bao gồm tất cả các trang bị trong bộ 'Ritual Garb of the Seeker' dành cho Bloodseeker:"
"DOTA_Bundle_Desc_Ursa_Iron_Bear"	"Bao gồm tất cả các trang bị trong bộ 'The Iron Bear' dành cho Ursa:"
"DOTA_Bundle_Desc_Ursa_Ravager"	"Bao gồm tất cả các trang bị trong bộ 'The Ursine Ravager' dành cho Ursa:"
"DOTA_Bundle_Desc_Ursa_Savage_Age"	"Bao gồm tất cả các trang bị trong bộ 'The Savage Age' dành cho Ursa:"
"DOTA_Bundle_Desc_Bounty_Hunter_Master_Assassin"	"Bao gồm tất cả trang bị trong bộ 'The Master Assassin' dành cho Bounty Hunter:"
"DOTA_Bundle_Desc_Omniknight_Hierophant"	"Bao gồm tất cả trang bị trong bộ 'The Hierophant's Protection' dành cho Omniknight:"
"DOTA_Bundle_Desc_Bloodseeker_Bonehunter"	"Bao gồm tất cả các trang bị trong bộ 'The Bonehunter' dành cho Bloodseeker:"
"DOTA_Bundle_Bounty_Hunter_Big_Bundle"	"Bounty Hunter's Fat Haul"
"DOTA_Bundle_Desc_Bounty_Hunter_Big_Bundle"	"Bao gồm tất cả trang bị cho Bounty Hunter phát hành đến tháng 8/2012:"
"DOTA_Bundle_Ursa_Big_Bundle"	"Gói Ursa's Primal"
"DOTA_Bundle_Desc_Ursa_Big_Bundle"	"Bao gồm tất cả các trang bị dành cho Ursa phát hành đến tháng 8/2012:"
"DOTA_Item_AntiMages_Armor"	"Giáp của Anti-Mage"
"DOTA_Item_Announcer_Axe"	"Phát thanh viên: Axe"
"DOTA_Bundle_Desc_Ursa_Alpine_Stalker"	"Bao gồm tất cả các trang bị trong bộ 'The Alpine Stalker' dành cho Ursa:"
"DOTA_Bundle_Desc_Talk_Like_A_Pirate_Day"	"Dù không phải là hải tặc, kể cả Kunkka vẫn đắm chìm trong không khí hải tặc trong ngày Nói Như một Hải tặc. Hãy gia nhập cùng ổng trong không khí lễ hội một ngày này, với một gói hàng mặc cả chứa tất cả món đồ mang phong cách hải tặc rẻ đến mức, cứ như là ăn cắp ý!"
"DOTA_Item_AntiMages_Glaive"	"Đoản kiếm của Anti-Mage"
"DOTA_Item_Centaurs_Axe"	"Rìu Của Centaur"
"DOTA_Item_League_atoD2"	"atoD 2"
"DOTA_Item_AbsoluteArena_King_of_the_Hill__Admin"	"AbsoluteArena King of the Hill - Admin"
"DOTA_Item_Medusas_Bow"	"Cung Tên của Medusa"
"DOTA_Item_Aegis_of_the_Storm"	"Aegis of the Storm"
"DOTA_Item_Ancestral_Cloak"	"Ancestral Cloak"
"DOTA_Item_Ancestral_Arm_Wrap"	"Ancestral Arm Wrap"
"DOTA_Item_Ancestral_Dress"	"Ancestral Dress"
"DOTA_Item_2012_Polycount_Ward"	"Mắt 2012 Polycount"
"DOTA_Item_Pile_of_Coal"	"Đống Than"
"DOTA_Item_75_Battle_Bonus_2_Hours"	"75% Điểm Thưởng trận đấu (2 Tiếng)"
"DOTA_Item_Desc_75_Battle_Bonus_2_Hours"	"Sử dụng vật phẩm này để tăng mức thưởng <font color='#9da1a9'>Điểm chiến đấu</font> lên <font color='#9da1a9'>75%</font> trong 2 giờ. Thêm vào đó, bạn còn cung cấp cho những người chơi trong trận đấu thêm <font color='#9da1a9'>15%</font> cộng dồn vào mức thưởng <font color='#9da1a9'>Điểm chiến đấu</font> của họ."
"DOTA_Item_100_Battle_Bonus_2_Hours"	"Thưởng 100% Điểm trận đấu (2 Giờ)"
"DOTA_Item_200_Battle_Bonus_2_Hours"	"200% Điểm Thưởng trận đấu (2 Tiếng)"
"DOTA_Bundle_Desc_Faceless_Void_Chronite"	"Bao gồm tất cả các trang bị trong bộ 'Chronite Defense' dành cho Faceless Void:"
"DOTA_Item_4Players_League"	"4Players League"
"DOTA_Item_4Players_League__ADMIN"	"4Players League - ADMIN"
"DOTA_Item_Alchemy_Essentials_Set"	"Bộ Alchemy Essentials"
"DOTA_Item_Ancestors_Pride_Set"	"Bộ Ancestors' Pride"
"DOTA_Item_Ancestors_Belt"	"Ancestors' Belt"
"DOTA_Item_Ancestors_Edge"	"Ancestors' Edge"
"DOTA_Item_Ancestors_Pauldron"	"Ancestors' Pauldron"
"DOTA_Item_Ancestors_Vambrace"	"Ancestors' Vambrace"
"DOTA_Item_Snowl"	"Snowl"
"DOTA_Item_Ancestral_Axes_of_Karroch"	"Ancestral Axes of Karroch"
"DOTA_Item_Ancestral_Belt_of_Karroch"	"Ancestral Belt of Karroch"
"DOTA_Item_Ancestral_Bracers_of_Karroch"	"Ancestral Bracers of Karroch"
"DOTA_Item_Akakiryu_of_a_Thousand_Faces"	"Akakiryu of a Thousand Faces"
"DOTA_Item_Ambinderaths_Jaw"	"Ambinderath's Jaw"
"DOTA_Item_AMD_Dota2_Premier_League"	"AMD Dota2 Premier League"
"DOTA_Item_AMD_Dota2_Premier_League_ADMIN"	"AMD Dota2 Premier League -ADMIN"
"DOTA_Item_Desc_International_2013_Battle_Bonus"	"Sử dụng vật phẩm này để tăng mức thưởng <font color='#9da1a9'>Điểm chiến đấu</font> lên <font color='#9da1a9'>125%</font> cho đến khi kết thúc giải đấu the International. Thêm vào đó, bạn còn cung cấp cho những người chơi trong trận đấu thêm <font color='#9da1a9'>25%</font> cộng dồn vào mức thưởng <font color='#9da1a9'>Điểm chiến đấu</font> của họ."
"DOTA_Item_American_Dota_League"	"American Dota League"
"DOTA_Item_American_Dota_League__ADMIN"	"American Dota League - ADMIN"
"DOTA_Item_Desc_100_Battle_Bonus_2_Hours"	"Sử dụng vật phẩm này để tăng mức thưởng <font color='#9da1a9'>Điểm chiến đấu</font> lên <font color='#9da1a9'>100%</font> trong 2 giờ. Thêm vào đó, bạn còn cung cấp cho những người chơi trong trận đấu thêm <font color='#9da1a9'>15%</font> cộng dồn vào mức thưởng <font color='#9da1a9'>Điểm chiến đấu</font> của họ."
"DOTA_Item_Desc_200_Battle_Bonus_2_Hours"	"Sử dụng vật phẩm này để tăng mức thưởng <font color='#9da1a9'>Điểm chiến đấu</font> lên <font color='#9da1a9'>200%</font> trong 2 giờ. Thêm vào đó, bạn còn cung cấp cho những người chơi trong trận đấu thêm <font color='#9da1a9'>15%</font> cộng dồn vào mức thưởng <font color='#9da1a9'>Điểm chiến đấu</font> của họ."
"DOTA_Item_Abaddons_Cape"	"Áo Choàng Của Abaddon"
"DOTA_Item_Abaddons_Helmet"	"Mũ của Abaddon"
"DOTA_Item_Abaddons_Mount"	"Thú cưỡi của Abaddon"
"DOTA_Item_Abaddons_Shoulder_Armor"	"Giáp Vai của Abaddon"
"DOTA_Item_Abaddons_Weapon"	"Vũ khí của Abaddon"
"DOTA_Item_Acolyte_of_Clasz_Set"	"Bộ Acolyte of Clasz"
"DOTA_Item_Ainidul_the_Eternal"	"Ainidul the Eternal"
"DOTA_Item_Alienware_Cup__2013_Season_1"	"Alienware Cup - 2013 Season 1"
"DOTA_Item_Alienware_Cup__2013_Season_1__ADMIN"	"Alienware Cup - 2013 Season 1 - ADMIN"
"DOTA_Item_AMD_Dota2_Premier_League_Season_2"	"AMD Dota2 Premier League Season 2"
"DOTA_Item_AMD_Dota2_Premier_League_Season_2__ADMIN"	"AMD Dota2 Premier League Season 2 - ADMIN"
"DOTA_Item_A_Dire_Gaze"	"A Dire Gaze"
"DOTA_Item_Aduron"	"Aduron"
"DOTA_Item_A_Bit_of_Boat"	"A Bit of Boat"
"DOTA_Item_Abaddons_Cowl_Down"	"Mũ chùm của Abaddon"
"DOTA_Item_Abaddons_Gryphon"	"Bằng Mã Của Abaddon"
"DOTA_Item_Abaddons_Raven_Shoulders"	"Vai Con quạ của Abaddon"
"DOTA_Item_Abaddons_Talon_Cape"	"Áo choàng Vuốt của Abaddon"
"DOTA_Item_Admirals_Prow"	"Admiral's Prow"
"DOTA_Item_AetherWings"	"Aether-Wings"
"DOTA_Item_Aghanims_Basher"	"Aghanim's Basher"
"DOTA_Item_Alpha_Predator_Set"	"Bộ Alpha Predator"
"DOTA_Item_Alphid_of_Lecaciida"	"Alphid of Lecaciida"
"DOTA_Item_Desc_80_Battle_Point_Booster_500_minutes"	"Sử dụng vật phẩm này để tăng mức thưởng <font color='#9da1a9'>Điểm chiến đấu</font> lên <font color='#9da1a9'>80%</font> trong 500 phút chơi game. Thêm vào đó, bạn còn cung cấp cho những người chơi trong trận đấu thêm <font color='#9da1a9'>16%</font> cộng dồn vào mức thưởng <font color='#9da1a9'>Điểm chiến đấu</font> của họ.<br><br>
Gói tăng điểm chiến đấu sẽ chỉ tính là được sử dụng khi bạn nhận được Điểm chiến đấu, các hoạt động như theo dõi trận đấu hay huấn luyện đều không bị ảnh hưởng."
"DOTA_WearableType_Battle_Point_Booster"	"Gói tăng điểm chiến đấu"
"DOTA_WearableType_Collector_of_Shining_Fragments"	"Gói tăng điểm chiến đấu"
"DOTA_Item_Desc_Single_Battle_Point_Booster"	"Sử dụng vật phẩm này để tăng mức thưởng <font color='#9da1a9'>Điểm chiến đấu</font> lên <font color='#9da1a9'>150%</font> cho một trận đấu duy nhất. Thêm vào đó, bạn còn cung cấp cho những người chơi trong trận đấu thêm <font color='#9da1a9'>5%</font> cộng dồn vào mức thưởng <font color='#9da1a9'>Điểm chiến đấu</font> của họ.<br><br>
Gói tăng điểm chiến đấu sẽ chỉ tính là được sử dụng khi bạn nhận được Điểm chiến đấu, các hoạt động như theo dõi trận đấu hay huấn luyện đều không bị ảnh hưởng."
"DOTA_Item_Noctis_the_Heavenly_Qilin_Guardian"	"Noctis the Heavenly Qilin Guardian"
"DOTA_Item_Desc_175_Battle_Point_Booster_3_Days"	"Sử dụng vật phẩm này để tăng mức thưởng <font color='#9da1a9'>Điểm chiến đấu</font> lên <font color='#9da1a9'>175%</font> trong 3 ngày. Thêm vào đó, bạn còn cung cấp cho những người chơi trong trận đấu thêm <font color='#9da1a9'>15%</font> cộng dồn vào mức thưởng <font color='#9da1a9'>Điểm chiến đấu</font> của họ."
"DOTA_Item_Desc_175_Battle_Point_Booster_6_Days"	"Sử dụng vật phẩm này để tăng mức thưởng <font color='#9da1a9'>Điểm chiến đấu</font> lên <font color='#9da1a9'>175%</font> trong 6 ngày. Thêm vào đó, bạn còn cung cấp cho những người chơi trong trận đấu thêm <font color='#9da1a9'>15%</font> cộng dồn vào mức thưởng <font color='#9da1a9'>Điểm chiến đấu</font> của họ."
"DOTA_Item_Desc_180_Battle_Point_Booster_500_minutes"	"Sử dụng vật phẩm này để tăng mức thưởng <font color='#9da1a9'>Điểm chiến đấu</font> lên <font color='#9da1a9'>180%</font> trong 500 phút chơi game. Thêm vào đó, bạn còn cung cấp cho những người chơi trong trận đấu thêm <font color='#9da1a9'>16%</font> cộng dồn vào mức thưởng <font color='#9da1a9'>Điểm chiến đấu</font> của họ.<br><br>
Gói tăng điểm chiến đấu sẽ chỉ tính là được sử dụng khi bạn nhận được Điểm chiến đấu, các hoạt động như theo dõi trận đấu hay huấn luyện đều không bị ảnh hưởng."
"DOTA_Item_Octopus"	"Octopus"
"DOTA_Item_Trove_Carafe_279471378"	"Trove Carafe đã được ký bởi 李坏"
"DOTA_Item_Desc_Pudgling_Golden_Hook_Upgrade"	"Vật phẩm này cho phép kiểu dáng 'Golden Hook' được mở khóa trên Pudgling thông qua trình đơn kiểu dáng."
"DOTA_Item_Desc_Lt_Squawkins_Rowboat_Upgrade"	"Vật phẩm này cho phép kiểu dáng 'Rowboat' được mở khóa trên Lt. Squawkins thông qua trình đơn kiểu dáng."
"DOTA_Item_Desc_Lt_Squawkins_Sailboat_Upgrade"	"Vật phẩm này cho phép kiểu dáng 'Sailboat' được mở khóa trên Lt. Squawkins thông qua trình đơn kiểu dáng."
"DOTA_Item_Treasure_Redemption_Token"	"Xu đổi kho báu"
"DOTA_Item_Pauldrones_of_the_Basilisk"	"Pauldrones of the Basilisk"
"DOTA_Item_Desc_Krane_the_Enlightened_Upgrade"	"Vật phẩm này cho phép mở khóa kết cấu nâng cấp của 'Krane the Enlightened' thông qua trình đơn kiểu dáng. Nâng cấp này sẽ không thể trao đổi hay mua bán cho đến ngày 01 tháng 03 năm 2015."
"DOTA_Item_Desc_Wyvern_Hatchling_Fire_Upgrade"	"Vật phẩm này cho phép mở khóa kết cấu lửa nâng cấp cho 'Wyvern Hatchling' thông qua trình đơn kiểu dáng."
"DOTA_Item_Desc_Almond_the_Frondillo_Golden_Upgrade"	"Vật phẩm này cho phép mở khóa kết cấu vàng nâng cấp cho 'Almond the Frondillo' thông qua trình đơn kiểu dáng."
"DOTA_Item_Desc_Almond_the_Frondillo_Red_Upgrade"	"Vật phẩm này cho phép mở khóa kết cấu đỏ nâng cấp cho 'Almond the Frondillo' thông qua trình đơn kiểu dáng."
"DOTA_Item_Desc_Mantle_of_the_Cinder_Baron_Upgrade"	"Vật phẩm này cho phép mở khóa kết cấu nâng cấp cho 'Mantle of the Cinder Barono' của Axe thông qua trang chi tiết trang bị."
"DOTA_Item_Desc_Bindings_of_the_Battleranger_Style_Unlock"	"Phần thưởng của International 2016 này cho phép mở khóa kiểu dáng nâng cấp của bộ 'Bindings of the Battleranger' cho Windranger thông qua trình đơn kiểu dáng. Bạn có thể dùng vật phẩm này nhiều lần để mở khóa các kiểu dáng cho tất cả các trang bị của bộ."
"DOTA_Item_Desc_Onibi_Upgrade_Style_01"	"Phần thưởng của International 2016 này cho phép mở khóa kiểu dáng nâng cấp của thú 'Onibi' trong trình đơn kiểu dáng. Cấp độ này có thêm chiếc vỏ ở phía sau."
"DOTA_Item_Desc_Onibi_Upgrade_Style_10"	"Phần thưởng của International 2016 này cho phép mở khóa kiểu dáng nâng cấp của thú 'Onibi' trong trình đơn kiểu dáng. Cấp độ này có thêm sự thay đổi màu sắc."
"DOTA_Item_Desc_Onibi_Upgrade_Style_11"	"Phần thưởng của International 2016 này cho phép mở khóa kiểu dáng nâng cấp của thú 'Onibi' trong trình đơn kiểu dáng. Cấp độ này có thêm mặt nạ khác."
"DOTA_Item_Desc_Onibi_Upgrade_Style_12"	"Phần thưởng của International 2016 này cho phép mở khóa kiểu dáng nâng cấp của thú 'Onibi' trong trình đơn kiểu dáng. Cấp độ này có thêm cánh."
"DOTA_Item_Desc_Onibi_Upgrade_Style_13"	"Phần thưởng của International 2016 này cho phép mở khóa kiểu dáng nâng cấp của thú 'Onibi' trong trình đơn kiểu dáng. Cấp độ này có mặt nạ tai lớn hơn."
"DOTA_Item_Desc_Onibi_Upgrade_Style_14"	"Phần thưởng của International 2016 này cho phép mở khóa kiểu dáng nâng cấp của thú 'Onibi' trong trình đơn kiểu dáng. Cấp độ này có thêm hiệu ứng hạt."
"DOTA_Item_Desc_Onibi_Upgrade_Style_15"	"Phần thưởng của International 2016 này cho phép mở khóa kiểu dáng nâng cấp của thú 'Onibi' trong trình đơn kiểu dáng. Cấp độ này có thêm sự thay đổi màu sắc."
"DOTA_Item_Desc_Onibi_Upgrade_Style_16"	"Phần thưởng của International 2016 này cho phép mở khóa kiểu dáng nâng cấp của thú 'Onibi' trong trình đơn kiểu dáng. Cấp độ này có thêm mặt nạ khác."
"DOTA_Item_Desc_Onibi_Upgrade_Style_17"	"Phần thưởng của International 2016 này cho phép mở khóa kiểu dáng nâng cấp của thú 'Onibi' trong trình đơn kiểu dáng. Cấp độ này có thêm hiệu ứng hạt lửa."
"DOTA_Item_Desc_Onibi_Upgrade_Style_18"	"Phần thưởng của International 2016 này cho phép mở khóa kiểu dáng nâng cấp của thú 'Onibi' trong trình đơn kiểu dáng. Cấp độ này có thêm hiệu ứng hạt nóng chảy."
"DOTA_Item_Desc_Onibi_Upgrade_Style_19"	"Phần thưởng của International 2016 này cho phép mở khóa kiểu dáng nâng cấp của thú 'Onibi' trong trình đơn kiểu dáng. Cấp độ này có thêm bộ cánh khác."
"DOTA_Item_Desc_Onibi_Upgrade_Style_2"	"Phần thưởng của International 2016 này cho phép mở khóa kiểu dáng nâng cấp của thú 'Onibi' trong trình đơn kiểu dáng. Cấp độ này có thêm vỏ lá."
"DOTA_Item_Desc_Onibi_Upgrade_Style_20"	"Phần thưởng của International 2016 này cho phép mở khóa kiểu dáng nâng cấp của thú 'Onibi' trong trình đơn kiểu dáng. Cấp độ này có thêm khăn quàng và biểu ngữ."
"DOTA_Item_Desc_Onibi_Upgrade_Style_21"	"Phần thưởng của International 2016 này cho phép mở khóa kiểu dáng nâng cấp của thú 'Onibi' trong trình đơn kiểu dáng. Cấp độ cuối này có thêm sự thay đổi màu sắc, mặt nạ mới, và hiệu ứng hạt mới."
"DOTA_Item_Desc_Onibi_Upgrade_Style_3"	"Phần thưởng của International 2016này cho phép mở khóa kiểu dáng nâng cấp của thú 'Onibi' trong trình đơn kiểu dáng. Cấp độ này có thêm vỏ nấm và mắt sáng."
"DOTA_Item_Desc_Onibi_Upgrade_Style_4"	"Phần thưởng của International 2016 này cho phép mở khóa kiểu dáng nâng cấp của thú 'Onibi' trong trình đơn kiểu dáng. Cấp độ này có thêm hiệu ứng hạt."
"DOTA_Item_Desc_Onibi_Upgrade_Style_5"	"Phần thưởng của International 2016 này cho phép mở khóa kiểu dáng nâng cấp của thú 'Onibi' trong trình đơn kiểu dáng. Cấp độ này có thêm sự thay đổi màu sắc."
"DOTA_Item_Desc_Onibi_Upgrade_Style_6"	"Phần thưởng của International 2016 này cho phép mở khóa kiểu dáng nâng cấp của thú 'Onibi' trong trình đơn kiểu dáng. Cấp độ này có thêm mặt nạ, cổ áo, và dây chuyền."
"DOTA_Item_Desc_Onibi_Upgrade_Style_7"	"Phần thưởng của International 2016 này cho phép mở khóa kiểu dáng nâng cấp của thú 'Onibi' trong trình đơn kiểu dáng. Cấp độ này có thêm mặt nạ tai."
"DOTA_Item_Desc_Onibi_Upgrade_Style_8"	"Phần thưởng của International 2016 này cho phép mở khóa kiểu dáng nâng cấp của thú 'Onibi' trong trình đơn kiểu dáng. Cấp độ này có thêm mặt nạ tai lớn hơn và các trang trí trên mặt nạ."
"DOTA_Item_Desc_Onibi_Upgrade_Style_9"	"Phần thưởng của International 2016 này cho phép mở khóa kiểu dáng nâng cấp của thú 'Onibi' trong trình đơn kiểu dáng. Cấp độ này có thêm hiệu ứng hạt."
"DOTA_Item_Desc_Scale_of_the_Razorwyrm_Style_Unlock"	"Phần thưởng của International 2016 này cho phép mở khóa kiểu dáng nâng cấp của bộ 'Scale of the Razorwyrm' cho Ursa thông qua trình đơn kiểu dáng. Bạn có thể dùng vật phẩm này nhiều lần để mở khóa các kiểu dáng cho tất cả các trang bị của bộ."
"DOTA_Item_Desc_Smeevils_Penance_Upgrade_Style_01"	"Phần thưởng của International 2016 này cho phép mở khóa màu sắc nâng cấp cho mắt Smeevil's Penance trong trình đơn kiểu dáng."
"DOTA_Item_Desc_Smeevils_Penance_Upgrade_Style_02"	"Phần thưởng của International 2016 này cho phép mở khóa màu sắc nâng cấp cho mắt Smeevil's Penance trong trình đơn kiểu dáng."
"DOTA_Item_Desc_Smeevils_Penance_Upgrade_Style_03"	"Phần thưởng của International 2016 này cho phép mở khóa màu sắc nâng cấp cho mắt Smeevil's Penance trong trình đơn kiểu dáng."
"DOTA_Item_Desc_Smeevils_Penance_Upgrade_Style_04"	"Phần thưởng của International 2016 này cho phép mở khóa màu sắc nâng cấp cho mắt Smeevil's Penance trong trình đơn kiểu dáng."
"DOTA_Item_Desc_Urushin_Huntsman_Style_Unlock_"	"Phần thưởng của International 2016 này cho phép mở khóa kiểu dáng nâng cấp của bộ 'Urushin Huntsman' cho Clinkz thông qua trình đơn kiểu dáng. Bạn có thể dùng vật phẩm này nhiều lần để mở khóa các kiểu dáng cho tất cả các trang bị của bộ."
"DOTA_Item_Desc_Apostle_of_the_Tempest_Style_Unlock"	"Phần thưởng của Fall 2016 Battle Pass này cho phép mở khóa kiểu dáng nâng cấp của bộ 'Compact of the Guardian Construct' cho Razor thông qua trình đơn kiểu dáng. Bạn có thể dùng vật phẩm này nhiều lần để mở khóa các kiểu dáng cho tất cả các trang bị của bộ."
"DOTA_Item_Desc_Effigy_Block_of_The_Fall_2016_Battle_Pass__Level_I"	"Dùng vật phẩm này để khắc tướng yêu thích của bạn vào Tượng Anh Hùng của Fall 2016 Battle Pass! Chọn tư thế của tượng, khắc thêm dòng chữ, sau đó trang bị nó để bức tượng sau khi đã tùy chỉnh xuất hiện trong căn cứ của đội bạn cho tất cả có thể chiêm ngưỡng. Cung cấp độc quyền cho chủ sở hữu của Fall 2016 Battle Pass"
"DOTA_Item_Desc_Kit_of_the_First_Hunt_Style_Unlock"	"Phần thưởng của Fall 2016 Battle Pass này cho phép mở khóa kiểu dáng nâng cấp của bộ 'Kit of the First Hunt' cho Bounty Hunter thông qua trình đơn kiểu dáng. Bạn có thể dùng vật phẩm này nhiều lần để mở khóa các kiểu dáng cho tất cả các trang bị của bộ."
"DOTA_Item_Desc_Lucid_Torment_Style_Unlock"	"Phần thưởng của Fall 2016 Battle Pass này cho phép mở khóa kiểu dáng nâng cấp của bộ 'Lucid Torment' cho Bane thông qua trình đơn kiểu dáng. Bạn có thể dùng vật phẩm này nhiều lần để mở khóa các kiểu dáng cho tất cả các trang bị của bộ."
}
}
