"lang"
{
"Language"	"russian"
"Tokens"
{
"#TF_RichPresence_Display"	"{#TF_RichPresence_State_%state%}"
"[english]#TF_RichPresence_Display"	"{#TF_RichPresence_State_%state%}"
"#TF_RichPresence_State_MainMenu"	"В главном меню"
"[english]#TF_RichPresence_State_MainMenu"	"Main Menu"
"#TF_RichPresence_State_SearchingGeneric"	"Ищет игру"
"[english]#TF_RichPresence_State_SearchingGeneric"	"Searching for a Match"
"#TF_RichPresence_State_SearchingMatchGroup"	"Поиск ({#TF_RichPresence_MatchGroup_%matchgrouploc%})"
"[english]#TF_RichPresence_State_SearchingMatchGroup"	"Searching - {#TF_RichPresence_MatchGroup_%matchgrouploc%}"
"#TF_RichPresence_State_PlayingGeneric"	"В игре: %currentmap%"
"[english]#TF_RichPresence_State_PlayingGeneric"	"In Match - %currentmap%"
"#TF_RichPresence_State_LoadingGeneric"	"Заходит на сервер"
"[english]#TF_RichPresence_State_LoadingGeneric"	"Joining Match"
"#TF_RichPresence_State_PlayingMatchGroup"	"{#TF_RichPresence_MatchGroup_%matchgrouploc%}: %currentmap%"
"[english]#TF_RichPresence_State_PlayingMatchGroup"	"{#TF_RichPresence_MatchGroup_%matchgrouploc%} - %currentmap%"
"#TF_RichPresence_State_LoadingMatchGroup"	"Заходит на сервер ({#TF_RichPresence_MatchGroup_%matchgrouploc%})"
"[english]#TF_RichPresence_State_LoadingMatchGroup"	"Joining {#TF_RichPresence_MatchGroup_%matchgrouploc%}"
"#TF_RichPresence_State_PlayingCommunity"	"Сервер сообщества: %currentmap%"
"[english]#TF_RichPresence_State_PlayingCommunity"	"Community - %currentmap%"
"#TF_RichPresence_State_LoadingCommunity"	"Заходит на сервер сообщества"
"[english]#TF_RichPresence_State_LoadingCommunity"	"Joining Community Server"
"#TF_RichPresence_MatchGroup_Competitive6v6"	"Соревновательная игра"
"[english]#TF_RichPresence_MatchGroup_Competitive6v6"	"Competitive"
"#TF_RichPresence_MatchGroup_Casual"	"Обычная игра"
"[english]#TF_RichPresence_MatchGroup_Casual"	"Casual"
"#TF_RichPresence_MatchGroup_SpecialEvent"	"Особое событие"
"[english]#TF_RichPresence_MatchGroup_SpecialEvent"	"Special Event"
"#TF_RichPresence_MatchGroup_MannUp"	"МпМ: МАННёвры"
"[english]#TF_RichPresence_MatchGroup_MannUp"	"MvM Mann Up"
"#TF_RichPresence_MatchGroup_BootCamp"	"МпМ: учебка"
"[english]#TF_RichPresence_MatchGroup_BootCamp"	"MvM Boot Camp"
}
}
