"hero_chat_wheel"
{
"dota_chatwheel_message_antimage_laugh"	"Ha ha ha ha ha ha ha ha ha ha ha ha!"
"[english]dota_chatwheel_message_antimage_laugh"	"Ha ha ha ha ha ha ha ha ha ha ha ha!"
"dota_chatwheel_label_antimage_laugh"	"[Risada]"
"[english]dota_chatwheel_label_antimage_laugh"	"Laugh"
"dota_chatwheel_message_antimage_thank"	"Eu darei uma surra que eles não esquecerão tão cedo!"
"[english]dota_chatwheel_message_antimage_thank"	"I'll give them a drubbing they'll not soon forget!"
"dota_chatwheel_label_antimage_thank"	"Eu darei uma surra..."
"[english]dota_chatwheel_label_antimage_thank"	"I'll give them a drubbing..."
"dota_chatwheel_message_antimage_deny"	"Você está ao menos tentando?"
"[english]dota_chatwheel_message_antimage_deny"	"Are you even trying?"
"dota_chatwheel_label_antimage_deny"	"Você está ao menos tentando?"
"[english]dota_chatwheel_label_antimage_deny"	"Are you even trying?"
"dota_chatwheel_message_antimage_1"	"A magia é uma abominação."
"[english]dota_chatwheel_message_antimage_1"	"Magic is an abomination."
"dota_chatwheel_label_antimage_1"	"A magia é uma abominação."
"[english]dota_chatwheel_label_antimage_1"	"Magic is an abomination."
"dota_chatwheel_message_antimage_2"	"Decepcionante."
"[english]dota_chatwheel_message_antimage_2"	"A disappointment."
"dota_chatwheel_label_antimage_2"	"Decepcionante."
"[english]dota_chatwheel_label_antimage_2"	"A disappointment."
"dota_chatwheel_message_antimage_3"	"Tira essa magia de ti."
"[english]dota_chatwheel_message_antimage_3"	"Magic thyself out of that."
"dota_chatwheel_label_antimage_3"	"Tira essa magia de ti."
"[english]dota_chatwheel_label_antimage_3"	"Magic thyself out of that."
"dota_chatwheel_message_antimage_4"	"Estejas condenado!"
"[english]dota_chatwheel_message_antimage_4"	"Thou art damned!"
"dota_chatwheel_label_antimage_4"	"Estejas condenado."
"[english]dota_chatwheel_label_antimage_4"	"Thou art damned."
"dota_chatwheel_message_antimage_5"	"Envie as legiões do teu Deus Morto, eu mandarei todos para a morte."
"[english]dota_chatwheel_message_antimage_5"	"Send thy Dead God's legions, I will put them all to death."
"dota_chatwheel_label_antimage_5"	"Envie as legiões do teu Deus Morto..."
"[english]dota_chatwheel_label_antimage_5"	"Send thy Dead God's legions..."
"dota_chatwheel_message_axe_laugh"	"Ha ha ha ha ha ha!"
"[english]dota_chatwheel_message_axe_laugh"	"Ha ha ha ha ha ha!"
"dota_chatwheel_label_axe_laugh"	"[Risada]"
"[english]dota_chatwheel_label_axe_laugh"	"Laugh"
"dota_chatwheel_message_axe_thank"	"O Axe gosta muito disso."
"[english]dota_chatwheel_message_axe_thank"	"Axe likes this very much."
"dota_chatwheel_label_axe_thank"	"O Axe gosta muito disso."
"[english]dota_chatwheel_label_axe_thank"	"Axe likes this very much."
"dota_chatwheel_message_axe_deny"	"Você não merece nada!"
"[english]dota_chatwheel_message_axe_deny"	"You deserve nothing!"
"dota_chatwheel_label_axe_deny"	"Você não merece nada!"
"[english]dota_chatwheel_label_axe_deny"	"You deserve nothing!"
"dota_chatwheel_message_axe_1"	"Você lutou mal — e morreu pior."
"[english]dota_chatwheel_message_axe_1"	"You fought badly--died worse."
"dota_chatwheel_label_axe_1"	"Você lutou mal"
"[english]dota_chatwheel_label_axe_1"	"You fought badly"
"dota_chatwheel_message_axe_2"	"Eu já disse bom dia!"
"[english]dota_chatwheel_message_axe_2"	"I said good day, sir!"
"dota_chatwheel_label_axe_2"	"Eu já disse bom dia!"
"[english]dota_chatwheel_label_axe_2"	"I said good day, sir!"
"dota_chatwheel_message_axe_3"	"O Axe calculou errado?"
"[english]dota_chatwheel_message_axe_3"	"Axe misjudged?"
"dota_chatwheel_label_axe_3"	"O Axe calculou errado?"
"[english]dota_chatwheel_label_axe_3"	"Axe misjudged?"
"dota_chatwheel_message_axe_4"	"O Axe não tem tempo para essa baboseira."
"[english]dota_chatwheel_message_axe_4"	"Axe has no time for all this jibber-jabber."
"dota_chatwheel_label_axe_4"	"O Axe não tem tempo para essa baboseira."
"[english]dota_chatwheel_label_axe_4"	"Axe has no time for all this jibber-jabber."
"dota_chatwheel_message_axe_5"	"O que aconteceu? Axe aconteceu!"
"[english]dota_chatwheel_message_axe_5"	"What happened? Axe happened!"
"dota_chatwheel_label_axe_5"	"O que aconteceu? Axe aconteceu!"
"[english]dota_chatwheel_label_axe_5"	"What happened? Axe happened!"
"dota_chatwheel_message_bane_laugh"	"Ha ha ha ha ha ha ha ha ha!"
"[english]dota_chatwheel_message_bane_laugh"	"Ha ha ha ha ha ha ha ha ha!"
"dota_chatwheel_label_bane_laugh"	"[Risada]"
"[english]dota_chatwheel_label_bane_laugh"	"Laugh"
"dota_chatwheel_message_bane_thank"	"Você é tão legal."
"[english]dota_chatwheel_message_bane_thank"	"You're so nice."
"dota_chatwheel_label_bane_thank"	"Você é tão legal."
"[english]dota_chatwheel_label_bane_thank"	"You're so nice."
"dota_chatwheel_message_bane_deny"	"Boa sorte da próxima vez."
"[english]dota_chatwheel_message_bane_deny"	"Better luck next time."
"dota_chatwheel_label_bane_deny"	"Boa sorte da próxima vez."
"[english]dota_chatwheel_label_bane_deny"	"Better luck next time."
"dota_chatwheel_message_bane_1"	"A desgraça da sua existência."
"[english]dota_chatwheel_message_bane_1"	"Bane of your existence."
"dota_chatwheel_label_bane_1"	"A desgraça da sua existência."
"[english]dota_chatwheel_label_bane_1"	"Bane of your existence."
"dota_chatwheel_message_bane_2"	"Eu sonhava com este momento."
"[english]dota_chatwheel_message_bane_2"	"I've been dreaming of this moment."
"dota_chatwheel_label_bane_2"	"Eu sonhava com este momento."
"[english]dota_chatwheel_label_bane_2"	"I've been dreaming of this moment."
"dota_chatwheel_message_bane_3"	"Troca justa."
"[english]dota_chatwheel_message_bane_3"	"Fair exchange."
"dota_chatwheel_label_bane_3"	"Troca justa."
"[english]dota_chatwheel_label_bane_3"	"Fair exchange."
"dota_chatwheel_message_bane_4"	"Agora o seu pesadelo dura para sempre."
"[english]dota_chatwheel_message_bane_4"	"Now your nightmare lasts forever."
"dota_chatwheel_label_bane_4"	"Agora o seu pesadelo dura para sempre."
"[english]dota_chatwheel_label_bane_4"	"Now your nightmare lasts forever."
"dota_chatwheel_message_bloodseeker_laugh"	"Hmm-heh-heh-heh-heh-ha!"
"[english]dota_chatwheel_message_bloodseeker_laugh"	"Hmm-heh-heh-heh-heh-ha!"
"dota_chatwheel_label_bloodseeker_laugh"	"[Risada]"
"[english]dota_chatwheel_label_bloodseeker_laugh"	"Laugh"
"dota_chatwheel_message_bloodseeker_thank"	"Quanto sangue."
"[english]dota_chatwheel_message_bloodseeker_thank"	"So much blood."
"dota_chatwheel_label_bloodseeker_thank"	"Quanto sangue."
"[english]dota_chatwheel_label_bloodseeker_thank"	"So much blood."
"dota_chatwheel_message_bloodseeker_deny"	"Sem sangue para você."
"[english]dota_chatwheel_message_bloodseeker_deny"	"No blood for you."
"dota_chatwheel_label_bloodseeker_deny"	"Sem sangue para você."
"[english]dota_chatwheel_label_bloodseeker_deny"	"No blood for you."
"dota_chatwheel_message_bloodseeker_1"	"Estou vendo vermelho... e adorando!"
"[english]dota_chatwheel_message_bloodseeker_1"	"I'm seeing red...and it's amazing!"
"dota_chatwheel_label_bloodseeker_1"	"Estou vendo vermelho... e adorando!"
"[english]dota_chatwheel_label_bloodseeker_1"	"I'm seeing red...and it's amazing!"
"dota_chatwheel_message_bloodseeker_2"	"Não seja negativo... seja positivo."
"[english]dota_chatwheel_message_bloodseeker_2"	"Don't be negative...be positive."
"dota_chatwheel_label_bloodseeker_2"	"Não seja negativo..."
"[english]dota_chatwheel_label_bloodseeker_2"	"Don't be negative..."
"dota_chatwheel_message_bloodseeker_3"	"Vai lá... corre."
"[english]dota_chatwheel_message_bloodseeker_3"	"Go ahead...run."
"dota_chatwheel_label_bloodseeker_3"	"Vai lá... corre."
"[english]dota_chatwheel_label_bloodseeker_3"	"Go ahead...run."
"dota_chatwheel_message_bloodseeker_4"	"Pode deitar... toma um biscoitinho."
"[english]dota_chatwheel_message_bloodseeker_4"	"Lie down...have a cookie."
"dota_chatwheel_label_bloodseeker_4"	"Pode deitar... toma um biscoitinho."
"[english]dota_chatwheel_label_bloodseeker_4"	"Lie down...have a cookie."
"dota_chatwheel_message_bloodseeker_5"	"Acima do campo de batalha, o cheiro de sangue sobe como uma promessa."
"[english]dota_chatwheel_message_bloodseeker_5"	"Over the field of battle, the smell of blood rises like a promise."
"dota_chatwheel_label_bloodseeker_5"	"Acima do campo de batalha..."
"[english]dota_chatwheel_label_bloodseeker_5"	"Over the field of battle..."
"dota_chatwheel_message_crystal_maiden_laugh"	"Ah ha ha ha ha ha."
"[english]dota_chatwheel_message_crystal_maiden_laugh"	"Ah ha ha ha ha ha."
"dota_chatwheel_label_crystal_maiden_laugh"	"[Risada]"
"[english]dota_chatwheel_label_crystal_maiden_laugh"	"Laugh"
"dota_chatwheel_message_crystal_maiden_deny"	"Agora ninguém ganha!"
"[english]dota_chatwheel_message_crystal_maiden_deny"	"Now nobody wins!"
"dota_chatwheel_label_crystal_maiden_deny"	"Agora ninguém ganha!"
"[english]dota_chatwheel_label_crystal_maiden_deny"	"Now nobody wins!"
"dota_chatwheel_message_crystal_maiden_1"	"Pronto, mais um anjinho de neve."
"[english]dota_chatwheel_message_crystal_maiden_1"	"You'll make a nice snow angel."
"dota_chatwheel_label_crystal_maiden_1"	"Pronto, mais um anjinho de neve."
"[english]dota_chatwheel_label_crystal_maiden_1"	"You'll make a nice snow angel."
"dota_chatwheel_message_crystal_maiden_2"	"Estou com calafrios!"
"[english]dota_chatwheel_message_crystal_maiden_2"	"I've got goosebumps!"
"dota_chatwheel_label_crystal_maiden_2"	"Estou com calafrios!"
"[english]dota_chatwheel_label_crystal_maiden_2"	"I've got goosebumps!"
"dota_chatwheel_message_crystal_maiden_3"	"Eu não esperava por essa."
"[english]dota_chatwheel_message_crystal_maiden_3"	"I didn't see that coming."
"dota_chatwheel_label_crystal_maiden_3"	"Eu não esperava por essa."
"[english]dota_chatwheel_label_crystal_maiden_3"	"I didn't see that coming."
"dota_chatwheel_message_crystal_maiden_4"	"O dia está ficando cada vez melhor."
"[english]dota_chatwheel_message_crystal_maiden_4"	"It just keeps getting better."
"dota_chatwheel_label_crystal_maiden_4"	"O dia está ficando cada vez melhor."
"[english]dota_chatwheel_label_crystal_maiden_4"	"It just keeps getting better."
"dota_chatwheel_message_crystal_maiden_5"	"Está frio aqui ou sou eu?"
"[english]dota_chatwheel_message_crystal_maiden_5"	"Is it cold in here or is it just me?"
"dota_chatwheel_label_crystal_maiden_5"	"Está frio aqui ou..."
"[english]dota_chatwheel_label_crystal_maiden_5"	"Is it cold in here or..."
"dota_chatwheel_message_drow_ranger_laugh"	"Ah ha ha ha ha ha ha ha ha ha ha ha ha ha!"
"[english]dota_chatwheel_message_drow_ranger_laugh"	"Ah ha ha ha ha ha ha ha ha ha ha ha ha ha!"
"dota_chatwheel_label_drow_ranger_laugh"	"[Risada]"
"[english]dota_chatwheel_label_drow_ranger_laugh"	"Laugh"
"dota_chatwheel_message_drow_ranger_thank"	"Mais um triunfo!"
"[english]dota_chatwheel_message_drow_ranger_thank"	"Another triumph!"
"dota_chatwheel_label_drow_ranger_thank"	"Mais um triunfo!"
"[english]dota_chatwheel_label_drow_ranger_thank"	"Another triumph!"
"dota_chatwheel_message_drow_ranger_deny"	"Você terá que fazer melhor!"
"[english]dota_chatwheel_message_drow_ranger_deny"	"You'll have to do better than that!"
"dota_chatwheel_label_drow_ranger_deny"	"Você terá que fazer melhor!"
"[english]dota_chatwheel_label_drow_ranger_deny"	"You'll have to do better than that!"
"dota_chatwheel_message_drow_ranger_1"	"Você fazia barulho demais."
"[english]dota_chatwheel_message_drow_ranger_1"	"You were too noisy to live."
"dota_chatwheel_label_drow_ranger_1"	"Você fazia barulho demais."
"[english]dota_chatwheel_label_drow_ranger_1"	"You were too noisy to live."
"dota_chatwheel_message_drow_ranger_2"	"Amadores..."
"[english]dota_chatwheel_message_drow_ranger_2"	"Amateur."
"dota_chatwheel_label_drow_ranger_2"	"Amadores..."
"[english]dota_chatwheel_label_drow_ranger_2"	"Amateur."
"dota_chatwheel_message_drow_ranger_3"	"Você morre sem ninguém."
"[english]dota_chatwheel_message_drow_ranger_3"	"You die alone."
"dota_chatwheel_label_drow_ranger_3"	"Você morre sem ninguém."
"[english]dota_chatwheel_label_drow_ranger_3"	"You die alone."
"dota_chatwheel_message_drow_ranger_5"	"Agora que você morreu, é fácil te respeitar."
"[english]dota_chatwheel_message_drow_ranger_5"	"Now that you're dead, I find it easy to respect you."
"dota_chatwheel_label_drow_ranger_5"	"Agora que você morreu..."
"[english]dota_chatwheel_label_drow_ranger_5"	"Now that you're dead..."
"dota_chatwheel_message_earthshaker_laugh"	"Ha ha ha ha ha ha ha ha ha."
"[english]dota_chatwheel_message_earthshaker_laugh"	"Ha ha ha ha ha ha ha ha ha."
"dota_chatwheel_label_earthshaker_laugh"	"[Risada]"
"[english]dota_chatwheel_label_earthshaker_laugh"	"Laugh"
"dota_chatwheel_message_earthshaker_thank"	"Vamos botar pra quebrar!"
"[english]dota_chatwheel_message_earthshaker_thank"	"Let's shake things up!"
"dota_chatwheel_label_earthshaker_thank"	"Vamos botar pra quebrar!"
"[english]dota_chatwheel_label_earthshaker_thank"	"Let's shake things up!"
"dota_chatwheel_message_earthshaker_deny"	"Chocado..."
"[english]dota_chatwheel_message_earthshaker_deny"	"Shocking..."
"dota_chatwheel_label_earthshaker_deny"	"Chocado..."
"[english]dota_chatwheel_label_earthshaker_deny"	"Shocking..."
"dota_chatwheel_message_earthshaker_1"	"A culpa foi toda sua."
"[english]dota_chatwheel_message_earthshaker_1"	"It was your own damn fault."
"dota_chatwheel_label_earthshaker_1"	"A culpa foi toda sua."
"[english]dota_chatwheel_label_earthshaker_1"	"It was your own damn fault."
"dota_chatwheel_message_earthshaker_2"	"Uau... Tremores secundários..."
"[english]dota_chatwheel_message_earthshaker_2"	"Whoa... Aftershocks..."
"dota_chatwheel_label_earthshaker_2"	"Uau... Tremores secundários..."
"[english]dota_chatwheel_label_earthshaker_2"	"Whoa... Aftershocks..."
"dota_chatwheel_message_earthshaker_4"	"Estava ficando movimentado demais."
"[english]dota_chatwheel_message_earthshaker_4"	"It was getting far too crowded."
"dota_chatwheel_label_earthshaker_4"	"Estava ficando movimentado demais."
"[english]dota_chatwheel_label_earthshaker_4"	"It was getting far too crowded."
"dota_chatwheel_message_earthshaker_5"	"Podem haver muitas terras, mas há apenas um Earthshaker."
"[english]dota_chatwheel_message_earthshaker_5"	"There may be many earths, but there's only one Earthshaker."
"dota_chatwheel_label_earthshaker_5"	"Podem haver muitas terras..."
"[english]dota_chatwheel_label_earthshaker_5"	"There may be many earths..."
"dota_chatwheel_message_juggernaut_laugh"	"Ha ha ha ha ha!"
"[english]dota_chatwheel_message_juggernaut_laugh"	"Ha ha ha ha ha!"
"dota_chatwheel_label_juggernaut_laugh"	"[Risada]"
"[english]dota_chatwheel_label_juggernaut_laugh"	"Laugh"
"dota_chatwheel_message_juggernaut_thank"	"Ah, legal."
"[english]dota_chatwheel_message_juggernaut_thank"	"Oh that's nice."
"dota_chatwheel_label_juggernaut_thank"	"Ah, legal."
"[english]dota_chatwheel_label_juggernaut_thank"	"Oh that's nice."
"dota_chatwheel_message_juggernaut_1"	"Você nunca terá alguém."
"[english]dota_chatwheel_message_juggernaut_1"	"You will be forever alone."
"dota_chatwheel_label_juggernaut_1"	"Você nunca terá alguém."
"[english]dota_chatwheel_label_juggernaut_1"	"You will be forever alone."
"dota_chatwheel_message_juggernaut_2"	"Tudo está se encaixando."
"[english]dota_chatwheel_message_juggernaut_2"	"It's all falling into place."
"dota_chatwheel_label_juggernaut_2"	"Tudo está se encaixando."
"[english]dota_chatwheel_label_juggernaut_2"	"It's all falling into place."
"dota_chatwheel_message_juggernaut_3"	"Eu termino depois."
"[english]dota_chatwheel_message_juggernaut_3"	"I'll be back to finish this later."
"dota_chatwheel_label_juggernaut_3"	"Eu termino depois."
"[english]dota_chatwheel_label_juggernaut_3"	"I'll be back to finish this later."
"dota_chatwheel_message_juggernaut_4"	"Há uma linha tênue entre a coragem e a estupidez."
"[english]dota_chatwheel_message_juggernaut_4"	"There's a fine line between bravery and stupidity."
"dota_chatwheel_label_juggernaut_4"	"Há uma linha tênue..."
"[english]dota_chatwheel_label_juggernaut_4"	"There's a fine line..."
"dota_chatwheel_message_mirana_laugh"	"Ha ha ha ha ha ha!"
"[english]dota_chatwheel_message_mirana_laugh"	"Ha ha ha ha ha ha!"
"dota_chatwheel_label_mirana_laugh"	"[Risada]"
"[english]dota_chatwheel_label_mirana_laugh"	"Laugh"
"dota_chatwheel_message_mirana_thank"	"Um presente da noite!"
"[english]dota_chatwheel_message_mirana_thank"	"A gift from the night!"
"dota_chatwheel_label_mirana_thank"	"Um presente da noite!"
"[english]dota_chatwheel_label_mirana_thank"	"A gift from the night!"
"dota_chatwheel_message_mirana_deny"	"Pegue-nos se puder!"
"[english]dota_chatwheel_message_mirana_deny"	"Catch us if you can!"
"dota_chatwheel_label_mirana_deny"	"Pegue-nos se puder!"
"[english]dota_chatwheel_label_mirana_deny"	"Catch us if you can!"
"dota_chatwheel_message_mirana_1"	"Você não aprendeu nada."
"[english]dota_chatwheel_message_mirana_1"	"You have learned nothing."
"dota_chatwheel_label_mirana_1"	"Você não aprendeu nada."
"[english]dota_chatwheel_label_mirana_1"	"You have learned nothing."
"dota_chatwheel_message_mirana_2"	"Ótimo trabalho!"
"[english]dota_chatwheel_message_mirana_2"	"Nicely done!"
"dota_chatwheel_label_mirana_2"	"Ótimo trabalho!"
"[english]dota_chatwheel_label_mirana_2"	"Nicely done!"
"dota_chatwheel_message_mirana_3"	"Corram, seus covardes!"
"[english]dota_chatwheel_message_mirana_3"	"Run like the dogs you are!"
"dota_chatwheel_label_mirana_3"	"Corram, seus covardes!"
"[english]dota_chatwheel_label_mirana_3"	"Run like the dogs you are!"
"dota_chatwheel_message_mirana_4"	"Aqui, gatinho-gatinho-gatinho..."
"[english]dota_chatwheel_message_mirana_4"	"Here, kitty-kitty-kitty...."
"dota_chatwheel_label_mirana_4"	"Aqui, gatinho-gatinho-gatinho..."
"[english]dota_chatwheel_label_mirana_4"	"Here, kitty-kitty-kitty...."
"dota_chatwheel_message_mirana_5"	"Não foi sorte, foi habilidade!"
"[english]dota_chatwheel_message_mirana_5"	"It was not luck but skill!"
"dota_chatwheel_label_mirana_5"	"Não foi sorte, foi habilidade!"
"[english]dota_chatwheel_label_mirana_5"	"It was not luck but skill!"
"dota_chatwheel_message_morphling_laugh"	"Ha ha ha ha ha ha ha ha ha ha!"
"[english]dota_chatwheel_message_morphling_laugh"	"Ha ha ha ha ha ha ha ha ha ha!"
"dota_chatwheel_label_morphling_laugh"	"[Risada]"
"[english]dota_chatwheel_label_morphling_laugh"	"Laugh"
"dota_chatwheel_message_morphling_thank"	"Estou gostando de ver."
"[english]dota_chatwheel_message_morphling_thank"	"I like what I see."
"dota_chatwheel_label_morphling_thank"	"Estou gostando de ver."
"[english]dota_chatwheel_label_morphling_thank"	"I like what I see."
"dota_chatwheel_message_morphling_1"	"Estou fervendo de raiva!"
"[english]dota_chatwheel_message_morphling_1"	"Boiling rage!"
"dota_chatwheel_label_morphling_1"	"Fúria fervente!"
"[english]dota_chatwheel_label_morphling_1"	"Boiling rage!"
"dota_chatwheel_message_morphling_2"	"Refrescante como sempre."
"[english]dota_chatwheel_message_morphling_2"	"Always refreshing."
"dota_chatwheel_label_morphling_2"	"Refrescante como sempre."
"[english]dota_chatwheel_label_morphling_2"	"Always refreshing."
"dota_chatwheel_message_morphling_3"	"A maré virou!"
"[english]dota_chatwheel_message_morphling_3"	"The tide has turned!"
"dota_chatwheel_label_morphling_3"	"A maré virou!"
"[english]dota_chatwheel_label_morphling_3"	"The tide has turned!"
"dota_chatwheel_message_morphling_4"	"Achou que eu estava tirando onda?"
"[english]dota_chatwheel_message_morphling_4"	"Didn't you see me waving?"
"dota_chatwheel_label_morphling_4"	"Achou que eu estava tirando onda?"
"[english]dota_chatwheel_label_morphling_4"	"Didn't you see me waving?"
"dota_chatwheel_message_morphling_5"	"Cuidado com a lavada!"
"[english]dota_chatwheel_message_morphling_5"	"You're washed up!"
"dota_chatwheel_label_morphling_5"	"Cuidado com a lavada!"
"[english]dota_chatwheel_label_morphling_5"	"You're washed up!"
"dota_chatwheel_message_nevermore_laugh"	"Ah ha ha ha ha ha!"
"[english]dota_chatwheel_message_nevermore_laugh"	"Ah ha ha ha ha ha!"
"dota_chatwheel_label_nevermore_laugh"	"[Risada]"
"[english]dota_chatwheel_label_nevermore_laugh"	"Laugh"
"dota_chatwheel_message_nevermore_thank"	"Que alma abençoada."
"[english]dota_chatwheel_message_nevermore_thank"	"Well bless your soul."
"dota_chatwheel_label_nevermore_thank"	"Que alma abençoada."
"[english]dota_chatwheel_label_nevermore_thank"	"Well bless your soul."
"dota_chatwheel_message_nevermore_deny"	"Superado."
"[english]dota_chatwheel_message_nevermore_deny"	"Outplayed."
"dota_chatwheel_label_nevermore_deny"	"Superado."
"[english]dota_chatwheel_label_nevermore_deny"	"Outplayed."
"dota_chatwheel_message_nevermore_1"	"Uma linda alma para a minha coleção."
"[english]dota_chatwheel_message_nevermore_1"	"A beautiful soul for my collection."
"dota_chatwheel_label_nevermore_1"	"Uma linda alma para a minha coleção."
"[english]dota_chatwheel_label_nevermore_1"	"A beautiful soul for my collection."
"dota_chatwheel_message_nevermore_2"	"Tema a minha presença."
"[english]dota_chatwheel_message_nevermore_2"	"Fear my presence."
"dota_chatwheel_label_nevermore_2"	"Tema a minha presença."
"[english]dota_chatwheel_label_nevermore_2"	"Fear my presence."
"dota_chatwheel_message_nevermore_4"	"Você não pode se esconder!"
"[english]dota_chatwheel_message_nevermore_4"	"You can never hide!"
"dota_chatwheel_label_nevermore_4"	"Você não pode se esconder!"
"[english]dota_chatwheel_label_nevermore_4"	"You can never hide!"
"dota_chatwheel_message_phantom_lancer_laugh"	"Ha ha ha ha ha ha ha ha ha ha ha ha ha!"
"[english]dota_chatwheel_message_phantom_lancer_laugh"	"Ha ha ha ha ha ha ha ha ha ha ha ha ha!"
"dota_chatwheel_label_phantom_lancer_laugh"	"[Risada]"
"[english]dota_chatwheel_label_phantom_lancer_laugh"	"Laugh"
"dota_chatwheel_message_phantom_lancer_thank"	"Que coisa maravilhosa."
"[english]dota_chatwheel_message_phantom_lancer_thank"	"What an amazing thing."
"dota_chatwheel_label_phantom_lancer_thank"	"Que coisa maravilhosa."
"[english]dota_chatwheel_label_phantom_lancer_thank"	"What an amazing thing."
"dota_chatwheel_message_phantom_lancer_deny"	"Tanta ingenuidade."
"[english]dota_chatwheel_message_phantom_lancer_deny"	"Such simple minds."
"dota_chatwheel_label_phantom_lancer_deny"	"Tanta ingenuidade."
"[english]dota_chatwheel_label_phantom_lancer_deny"	"Such simple minds."
"dota_chatwheel_message_phantom_lancer_1"	"Nós estamos prontos!"
"[english]dota_chatwheel_message_phantom_lancer_1"	"We come for you!"
"dota_chatwheel_label_phantom_lancer_1"	"Nós estamos prontos!"
"[english]dota_chatwheel_label_phantom_lancer_1"	"We come for you!"
"dota_chatwheel_message_phantom_lancer_3"	"Temos mais de onde viemos."
"[english]dota_chatwheel_message_phantom_lancer_3"	"We have more where that came from."
"dota_chatwheel_label_phantom_lancer_3"	"Temos mais de onde viemos."
"[english]dota_chatwheel_label_phantom_lancer_3"	"We have more where that came from."
"dota_chatwheel_message_phantom_lancer_4"	"Números conseguiram o que a estratégia não conseguiu."
"[english]dota_chatwheel_message_phantom_lancer_4"	"Numbers have accomplished what strategy alone could not."
"dota_chatwheel_label_phantom_lancer_4"	"Números conseguiram..."
"[english]dota_chatwheel_label_phantom_lancer_4"	"Numbers have accomplished..."
"dota_chatwheel_message_phantom_lancer_5"	"Somos mais do que você. Somos mais do que todos eles!"
"[english]dota_chatwheel_message_phantom_lancer_5"	"We outnumbered you. We outnumber them all!"
"dota_chatwheel_label_phantom_lancer_5"	"Somos mais do que você..."
"[english]dota_chatwheel_label_phantom_lancer_5"	"We outnumbered you..."
"dota_chatwheel_message_puck_laugh"	"Ha ha!"
"[english]dota_chatwheel_message_puck_laugh"	"Ha ha!"
"dota_chatwheel_label_puck_laugh"	"[Risada]"
"[english]dota_chatwheel_label_puck_laugh"	"Laugh"
"dota_chatwheel_message_puck_thank"	"Interessante."
"[english]dota_chatwheel_message_puck_thank"	"Interesting."
"dota_chatwheel_label_puck_thank"	"Interessante."
"[english]dota_chatwheel_label_puck_thank"	"Interesting."
"dota_chatwheel_message_puck_deny"	"Talvez você queira refazer o seu último movimento."
"[english]dota_chatwheel_message_puck_deny"	"You might wish to retract your last move."
"dota_chatwheel_label_puck_deny"	"Talvez você queira refazer..."
"[english]dota_chatwheel_label_puck_deny"	"You might wish to retract..."
"dota_chatwheel_message_puck_1"	"Saudações!"
"[english]dota_chatwheel_message_puck_1"	"Greetings!"
"dota_chatwheel_label_puck_1"	"Saudações!"
"[english]dota_chatwheel_label_puck_1"	"Greetings!"
"dota_chatwheel_message_puck_2"	"Que lugar é esse? Um jogo?"
"[english]dota_chatwheel_message_puck_2"	"What is this, a game of some sort?"
"dota_chatwheel_label_puck_2"	"Que lugar é esse? Um jogo?"
"[english]dota_chatwheel_label_puck_2"	"What is this, a game of some sort?"
"dota_chatwheel_message_puck_3"	"A maior tragédia do éon."
"[english]dota_chatwheel_message_puck_3"	"The greatest tragedy of our eon."
"dota_chatwheel_label_puck_3"	"A maior tragédia do éon."
"[english]dota_chatwheel_label_puck_3"	"The greatest tragedy of our eon."
"dota_chatwheel_message_puck_4"	"Foi inteligente?"
"[english]dota_chatwheel_message_puck_4"	"Was that smart?"
"dota_chatwheel_label_puck_4"	"Foi inteligente?"
"[english]dota_chatwheel_label_puck_4"	"Was that smart?"
"dota_chatwheel_message_puck_5"	"Eu desconheço este sentimento. É alegria?"
"[english]dota_chatwheel_message_puck_5"	"I am unfamiliar with this feeling. Is it joy?"
"dota_chatwheel_label_puck_5"	"Eu desconheço este sentimento..."
"[english]dota_chatwheel_label_puck_5"	"I am unfamiliar with this feeling..."
"dota_chatwheel_message_pudge_laugh"	"Hm hm hm hm ha ha ha."
"[english]dota_chatwheel_message_pudge_laugh"	"Hm hm hm hm ha ha ha."
"dota_chatwheel_label_pudge_laugh"	"[Risada]"
"[english]dota_chatwheel_label_pudge_laugh"	"Laugh"
"dota_chatwheel_message_pudge_thank"	"Isso serve."
"[english]dota_chatwheel_message_pudge_thank"	"That's a bit of all right."
"dota_chatwheel_label_pudge_thank"	"Isso serve."
"[english]dota_chatwheel_label_pudge_thank"	"That's a bit of all right."
"dota_chatwheel_message_pudge_deny"	"Ops. Fui eu?"
"[english]dota_chatwheel_message_pudge_deny"	"Oops. Was that me?"
"dota_chatwheel_label_pudge_deny"	"Ops. Fui eu?"
"[english]dota_chatwheel_label_pudge_deny"	"Oops. Was that me?"
"dota_chatwheel_message_pudge_1"	"Hora da carnificina!"
"[english]dota_chatwheel_message_pudge_1"	"Time for a little butchery!"
"dota_chatwheel_label_pudge_1"	"Hora da carnificina!"
"[english]dota_chatwheel_label_pudge_1"	"Time for a little butchery!"
"dota_chatwheel_message_pudge_2"	"Nada melhor do que um bom fígado cru."
"[english]dota_chatwheel_message_pudge_2"	"Nothing better than a nice raw liver."
"dota_chatwheel_label_pudge_2"	"Nada melhor do que um bom fígado cru."
"[english]dota_chatwheel_label_pudge_2"	"Nothing better than a nice raw liver."
"dota_chatwheel_message_pudge_3"	"Que seja."
"[english]dota_chatwheel_message_pudge_3"	"Whateva."
"dota_chatwheel_label_pudge_3"	"Que seja."
"[english]dota_chatwheel_label_pudge_3"	"Whateva."
"dota_chatwheel_message_pudge_4"	"Delícia..."
"[english]dota_chatwheel_message_pudge_4"	"Delicious..."
"dota_chatwheel_label_pudge_4"	"Delícia..."
"[english]dota_chatwheel_label_pudge_4"	"Delicious..."
"dota_chatwheel_message_razor_laugh"	"Ah ha ha ha ha ha ha ha ha."
"[english]dota_chatwheel_message_razor_laugh"	"Ah ha ha ha ha ha ha ha ha."
"dota_chatwheel_label_razor_laugh"	"[Risada]"
"[english]dota_chatwheel_label_razor_laugh"	"Laugh"
"dota_chatwheel_message_razor_thank"	"Eu sinto uma conexão entre nós!"
"[english]dota_chatwheel_message_razor_thank"	"I sense a connection between us!"
"dota_chatwheel_label_razor_thank"	"Eu sinto uma conexão entre nós!"
"[english]dota_chatwheel_label_razor_thank"	"I sense a connection between us!"
"dota_chatwheel_message_razor_deny"	"Você pode correr. Você deveria correr."
"[english]dota_chatwheel_message_razor_deny"	"You can run. You should run."
"dota_chatwheel_label_razor_deny"	"Você pode correr. Você deveria correr."
"[english]dota_chatwheel_label_razor_deny"	"You can run. You should run."
"dota_chatwheel_message_razor_1"	"Você morreu. Morreu."
"[english]dota_chatwheel_message_razor_1"	"You are dead. Dead."
"dota_chatwheel_label_razor_1"	"Você morreu. Morreu."
"[english]dota_chatwheel_label_razor_1"	"You are dead. Dead."
"dota_chatwheel_message_razor_2"	"As suas cinzas cairão como a chuva."
"[english]dota_chatwheel_message_razor_2"	"Your ashes will fall like rain."
"dota_chatwheel_label_razor_2"	"As suas cinzas cairão como a chuva."
"[english]dota_chatwheel_label_razor_2"	"Your ashes will fall like rain."
"dota_chatwheel_message_razor_3"	"Chocante."
"[english]dota_chatwheel_message_razor_3"	"Shocking."
"dota_chatwheel_label_razor_3"	"Chocante."
"[english]dota_chatwheel_label_razor_3"	"Shocking."
"dota_chatwheel_message_razor_4"	"Isto só doerá para sempre."
"[english]dota_chatwheel_message_razor_4"	"This will only hurt forever."
"dota_chatwheel_label_razor_4"	"Isto só doerá para sempre."
"[english]dota_chatwheel_label_razor_4"	"This will only hurt forever."
"dota_chatwheel_message_sand_king_laugh"	"Ha ha ha ha ha ha ha!"
"[english]dota_chatwheel_message_sand_king_laugh"	"Ha ha ha ha ha ha ha!"
"dota_chatwheel_label_sand_king_laugh"	"[Risada]"
"[english]dota_chatwheel_label_sand_king_laugh"	"Laugh"
"dota_chatwheel_message_sand_king_thank"	"Bom trabalho."
"[english]dota_chatwheel_message_sand_king_thank"	"You have done a great service."
"dota_chatwheel_label_sand_king_thank"	"Bom trabalho."
"[english]dota_chatwheel_label_sand_king_thank"	"You have done a great service."
"dota_chatwheel_message_sand_king_deny"	"Dói, não é?"
"[english]dota_chatwheel_message_sand_king_deny"	"Stings, don't it?"
"dota_chatwheel_label_sand_king_deny"	"Dói, não é?"
"[english]dota_chatwheel_label_sand_king_deny"	"Stings, don't it?"
"dota_chatwheel_message_sand_king_1"	"Curve-se para o seu soberano."
"[english]dota_chatwheel_message_sand_king_1"	"Bow to your liege."
"dota_chatwheel_label_sand_king_1"	"Curve-se para o seu soberano."
"[english]dota_chatwheel_label_sand_king_1"	"Bow to your liege."
"dota_chatwheel_message_sand_king_2"	"Uma vitória-a-a-arenosa!"
"[english]dota_chatwheel_message_sand_king_2"	"A Sandy V-V-Victory!"
"dota_chatwheel_label_sand_king_2"	"Uma vitória-a-a-arenosa!"
"[english]dota_chatwheel_label_sand_king_2"	"A Sandy V-V-Victory!"
"dota_chatwheel_message_sand_king_3"	"Aonde você pensa que vai?"
"[english]dota_chatwheel_message_sand_king_3"	"Where do you think you're going?"
"dota_chatwheel_label_sand_king_3"	"Aonde você pensa que vai?"
"[english]dota_chatwheel_label_sand_king_3"	"Where do you think you're going?"
"dota_chatwheel_message_sand_king_5"	"Como é bom ser Rei!"
"[english]dota_chatwheel_message_sand_king_5"	"It's good to be King!"
"dota_chatwheel_label_sand_king_5"	"Como é bom ser Rei"
"[english]dota_chatwheel_label_sand_king_5"	"It's good to be King"
"dota_chatwheel_message_storm_spirit_laugh"	"Hm hm hm hm hee hee hee ha ha."
"[english]dota_chatwheel_message_storm_spirit_laugh"	"Hm hm hm hm hee hee hee ha ha."
"dota_chatwheel_label_storm_spirit_laugh"	"[Risada]"
"[english]dota_chatwheel_label_storm_spirit_laugh"	"Laugh"
"dota_chatwheel_message_storm_spirit_thank"	"Esse é o espírito!"
"[english]dota_chatwheel_message_storm_spirit_thank"	"That's the spirit!"
"dota_chatwheel_label_storm_spirit_thank"	"Esse é o espírito!"
"[english]dota_chatwheel_label_storm_spirit_thank"	"That's the spirit!"
"dota_chatwheel_message_storm_spirit_deny"	"Você detonou!"
"[english]dota_chatwheel_message_storm_spirit_deny"	"You blew it!"
"dota_chatwheel_label_storm_spirit_deny"	"Você detonou!"
"[english]dota_chatwheel_label_storm_spirit_deny"	"You blew it!"
"dota_chatwheel_message_storm_spirit_1"	"Eu amo essa parte!"
"[english]dota_chatwheel_message_storm_spirit_1"	"I love this part!"
"dota_chatwheel_label_storm_spirit_1"	"Eu amo essa parte!"
"[english]dota_chatwheel_label_storm_spirit_1"	"I love this part!"
"dota_chatwheel_message_storm_spirit_2"	"Me procurando?"
"[english]dota_chatwheel_message_storm_spirit_2"	"Lookin for me?"
"dota_chatwheel_label_storm_spirit_2"	"Me procurando?"
"[english]dota_chatwheel_label_storm_spirit_2"	"Lookin for me?"
"dota_chatwheel_message_storm_spirit_3"	"Eu avisei que estava vindo uma tempestade!"
"[english]dota_chatwheel_message_storm_spirit_3"	"Told you a storm was coming!"
"dota_chatwheel_label_storm_spirit_3"	"Eu avisei que estava vindo uma tempestade!"
"[english]dota_chatwheel_label_storm_spirit_3"	"Told you a storm was coming!"
"dota_chatwheel_message_storm_spirit_4"	"Que beleza!"
"[english]dota_chatwheel_message_storm_spirit_4"	"Looking good!"
"dota_chatwheel_label_storm_spirit_4"	"Que beleza!"
"[english]dota_chatwheel_label_storm_spirit_4"	"Looking good!"
"dota_chatwheel_message_storm_spirit_5"	"Glorioso!"
"[english]dota_chatwheel_message_storm_spirit_5"	"Glorious!"
"dota_chatwheel_label_storm_spirit_5"	"Glorioso!"
"[english]dota_chatwheel_label_storm_spirit_5"	"Glorious!"
"dota_chatwheel_message_sven_laugh"	"Ahh ha ha ha! Ha ha ha ha!"
"[english]dota_chatwheel_message_sven_laugh"	"Ahh ha ha ha! Ha ha ha ha!"
"dota_chatwheel_label_sven_laugh"	"[Risada]"
"[english]dota_chatwheel_label_sven_laugh"	"Laugh"
"dota_chatwheel_message_sven_thank"	"Isso que é amizade."
"[english]dota_chatwheel_message_sven_thank"	"You are a true friend."
"dota_chatwheel_label_sven_thank"	"Isso que é amizade."
"[english]dota_chatwheel_label_sven_thank"	"You are a true friend."
"dota_chatwheel_message_sven_deny"	"Você parece atordoado."
"[english]dota_chatwheel_message_sven_deny"	"You look stunned."
"dota_chatwheel_label_sven_deny"	"Você parece atordoado."
"[english]dota_chatwheel_label_sven_deny"	"You look stunned."
"dota_chatwheel_message_sven_1"	"Mais uma vítima do Cavaleiro Rebelde."
"[english]dota_chatwheel_message_sven_1"	"Rogue Knight claims another."
"dota_chatwheel_label_sven_1"	"Mais uma vítima do Cavaleiro Rebelde."
"[english]dota_chatwheel_label_sven_1"	"Rogue Knight claims another."
"dota_chatwheel_message_sven_2"	"Você mereceu."
"[english]dota_chatwheel_message_sven_2"	"You deserved it."
"dota_chatwheel_label_sven_2"	"Você mereceu."
"[english]dota_chatwheel_label_sven_2"	"You deserved it."
"dota_chatwheel_message_sven_3"	"A minha honra me obriga... a zoar."
"[english]dota_chatwheel_message_sven_3"	"My honor compels me...to gloat."
"dota_chatwheel_label_sven_3"	"A minha honra me obriga... a zoar."
"[english]dota_chatwheel_label_sven_3"	"My honor compels me...to gloat."
"dota_chatwheel_message_sven_4"	"Um resultado esperado."
"[english]dota_chatwheel_message_sven_4"	"An expected outcome."
"dota_chatwheel_label_sven_4"	"Um resultado esperado."
"[english]dota_chatwheel_label_sven_4"	"An expected outcome."
"dota_chatwheel_message_sven_5"	"Hum... o que aprendemos com isso?"
"[english]dota_chatwheel_message_sven_5"	"Hm...now what do we learn from this."
"dota_chatwheel_label_sven_5"	"Hum... o que aprendemos com isso?"
"[english]dota_chatwheel_label_sven_5"	"Hm...now what do we learn from this."
"dota_chatwheel_message_tiny_laugh"	"Hehehehehuhhehehe."
"[english]dota_chatwheel_message_tiny_laugh"	"Hehehehehuhhehehe."
"dota_chatwheel_label_tiny_laugh"	"[Risada]"
"[english]dota_chatwheel_label_tiny_laugh"	"Laugh"
"dota_chatwheel_message_tiny_deny"	"Ora ora, olha só."
"[english]dota_chatwheel_message_tiny_deny"	"Well, look at that."
"dota_chatwheel_label_tiny_deny"	"Ora ora, olha só."
"[english]dota_chatwheel_label_tiny_deny"	"Well, look at that."
"dota_chatwheel_message_tiny_2"	"Bateu a cabeça numa rocha?"
"[english]dota_chatwheel_message_tiny_2"	"You got rocks in your head."
"dota_chatwheel_label_tiny_2"	"Bateu a cabeça numa rocha?"
"[english]dota_chatwheel_label_tiny_2"	"You got rocks in your head."
"dota_chatwheel_message_tiny_3"	"Sinto muito."
"[english]dota_chatwheel_message_tiny_3"	"My apologies."
"dota_chatwheel_label_tiny_3"	"Sinto muito."
"[english]dota_chatwheel_label_tiny_3"	"My apologies."
"dota_chatwheel_message_tiny_5"	"Ser bom assim é dureza."
"[english]dota_chatwheel_message_tiny_5"	"It's hard to be this good."
"dota_chatwheel_label_tiny_5"	"Ser bom assim é dureza."
"[english]dota_chatwheel_label_tiny_5"	"It's hard to be this good."
"dota_chatwheel_message_vengefulspirit_laugh"	"Hm ha ha ha ha ha ha!"
"[english]dota_chatwheel_message_vengefulspirit_laugh"	"Hm ha ha ha ha ha ha!"
"dota_chatwheel_label_vengefulspirit_laugh"	"[Risada]"
"[english]dota_chatwheel_label_vengefulspirit_laugh"	"Laugh"
"dota_chatwheel_message_vengefulspirit_thank"	"Tão bom..."
"[english]dota_chatwheel_message_vengefulspirit_thank"	"So sweet..."
"dota_chatwheel_label_vengefulspirit_thank"	"Tão bom..."
"[english]dota_chatwheel_label_vengefulspirit_thank"	"So sweet..."
"dota_chatwheel_message_vengefulspirit_deny"	"O quê...?"
"[english]dota_chatwheel_message_vengefulspirit_deny"	"What...?"
"dota_chatwheel_label_vengefulspirit_deny"	"O quê...?"
"[english]dota_chatwheel_label_vengefulspirit_deny"	"What...?"
"dota_chatwheel_message_vengefulspirit_1"	"Já estou me sentindo melhor."
"[english]dota_chatwheel_message_vengefulspirit_1"	"I feel better already."
"dota_chatwheel_label_vengefulspirit_1"	"Já estou me sentindo melhor."
"[english]dota_chatwheel_label_vengefulspirit_1"	"I feel better already."
"dota_chatwheel_message_vengefulspirit_2"	"Troquinhas!"
"[english]dota_chatwheel_message_vengefulspirit_2"	"Swapsies!"
"dota_chatwheel_label_vengefulspirit_2"	"Troquinhas!"
"[english]dota_chatwheel_label_vengefulspirit_2"	"Swapsies!"
"dota_chatwheel_message_vengefulspirit_3"	"Muahahhahahahahahaha!"
"[english]dota_chatwheel_message_vengefulspirit_3"	"Mwahahhahahahahahaha!"
"dota_chatwheel_label_vengefulspirit_3"	"Muahahhahahahahahaha!"
"[english]dota_chatwheel_label_vengefulspirit_3"	"Mwahahhahahahahahaha!"
"dota_chatwheel_message_vengefulspirit_4"	"Prepare-se para uma onda aterrorizante... bú!"
"[english]dota_chatwheel_message_vengefulspirit_4"	"Prepare for the wave of terror: boo!"
"dota_chatwheel_label_vengefulspirit_4"	"Prepare-se para uma onda aterrorizante... bú!"
"[english]dota_chatwheel_label_vengefulspirit_4"	"Prepare for the wave of terror: boo!"
"dota_chatwheel_message_vengefulspirit_5"	"A dor dos meus inimigos é o único prazer que me resta."
"[english]dota_chatwheel_message_vengefulspirit_5"	"The pain of my enemies is the only pleasure left to me."
"dota_chatwheel_label_vengefulspirit_5"	"A dor dos meus inimigos..."
"[english]dota_chatwheel_label_vengefulspirit_5"	"The pain of my enemies..."
"dota_chatwheel_message_windrunner_laugh"	"Hah-ha-ha-ha-ha!"
"[english]dota_chatwheel_message_windrunner_laugh"	"Hah-ha-ha-ha-ha!"
"dota_chatwheel_label_windrunner_laugh"	"[Risada]"
"[english]dota_chatwheel_label_windrunner_laugh"	"Laugh"
"dota_chatwheel_message_windrunner_deny"	"Hoje não."
"[english]dota_chatwheel_message_windrunner_deny"	"I don't think so."
"dota_chatwheel_label_windrunner_deny"	"Hoje não."
"[english]dota_chatwheel_label_windrunner_deny"	"I don't think so."
"dota_chatwheel_message_windrunner_1"	"Poderia ser pior. Peraí, não, não poderia."
"[english]dota_chatwheel_message_windrunner_1"	"Could be worse. Oh, wait, no it couldn't."
"dota_chatwheel_label_windrunner_1"	"Poderia ser pior..."
"[english]dota_chatwheel_label_windrunner_1"	"Could be worse..."
"dota_chatwheel_message_windrunner_2"	"Você não vai a lugar algum."
"[english]dota_chatwheel_message_windrunner_2"	"You're not going anywhere."
"dota_chatwheel_label_windrunner_2"	"Você não vai a lugar algum."
"[english]dota_chatwheel_label_windrunner_2"	"You're not going anywhere."
"dota_chatwheel_message_windrunner_3"	"Se você já não tivesse morrido, eu atiraria de novo."
"[english]dota_chatwheel_message_windrunner_3"	"If you weren't so damned dead, I'd shoot you again."
"dota_chatwheel_label_windrunner_3"	"Se você já não tivesse morrido..."
"[english]dota_chatwheel_label_windrunner_3"	"If you weren't so damned dead..."
"dota_chatwheel_message_windrunner_4"	"Me diga que isso não aconteceu."
"[english]dota_chatwheel_message_windrunner_4"	"Tell me this did not just happen."
"dota_chatwheel_label_windrunner_4"	"Me diga que isso não aconteceu."
"[english]dota_chatwheel_label_windrunner_4"	"Tell me this did not just happen."
"dota_chatwheel_message_windrunner_5"	"Beijinho no ombro."
"[english]dota_chatwheel_message_windrunner_5"	"I blow you a kiss."
"dota_chatwheel_label_windrunner_5"	"Beijinho no ombro."
"[english]dota_chatwheel_label_windrunner_5"	"I blow you a kiss."
"dota_chatwheel_message_zuus_laugh"	"Ha ha ha ha ha ha ha ha ha!"
"[english]dota_chatwheel_message_zuus_laugh"	"Ha ha ha ha ha ha ha ha ha!"
"dota_chatwheel_label_zuus_laugh"	"[Risada]"
"[english]dota_chatwheel_label_zuus_laugh"	"Laugh"
"dota_chatwheel_message_zuus_thank"	"Pelas minhas barbas, isso é bom!"
"[english]dota_chatwheel_message_zuus_thank"	"By my whiskers, that's good stuff!"
"dota_chatwheel_label_zuus_thank"	"Essa é das boas!"
"[english]dota_chatwheel_label_zuus_thank"	"That's good stuff!"
"dota_chatwheel_message_zuus_deny"	"Ha ha ha ha ha. Bem, o que você esperava?"
"[english]dota_chatwheel_message_zuus_deny"	"Ha ha ha ha ha. Well what did you expect?"
"dota_chatwheel_label_zuus_deny"	"Bem, o que você esperava?"
"[english]dota_chatwheel_label_zuus_deny"	"Well what did you expect?"
"dota_chatwheel_message_zuus_1"	"Me aguarde!"
"[english]dota_chatwheel_message_zuus_1"	"Wait for it!"
"dota_chatwheel_label_zuus_1"	"Me aguarde!"
"[english]dota_chatwheel_label_zuus_1"	"Wait for it!"
"dota_chatwheel_message_zuus_2"	"Só precisa disso para te matar?"
"[english]dota_chatwheel_message_zuus_2"	"That's all it takes to kill you?"
"dota_chatwheel_label_zuus_2"	"Só precisa disso..."
"[english]dota_chatwheel_label_zuus_2"	"That's all it takes..?"
"dota_chatwheel_message_zuus_3"	"Hum... isso não é nada bom."
"[english]dota_chatwheel_message_zuus_3"	"Oh...this can't be good."
"dota_chatwheel_label_zuus_3"	"Hum... isso não é nada bom."
"[english]dota_chatwheel_label_zuus_3"	"This can't be good"
"dota_chatwheel_message_zuus_4"	"Aplausos eletrizantes!"
"[english]dota_chatwheel_message_zuus_4"	"Thund'rous applause!"
"dota_chatwheel_label_zuus_4"	"Aplausos eletrizantes!"
"[english]dota_chatwheel_label_zuus_4"	"Thund'rous applause!"
"dota_chatwheel_message_zuus_5"	"Você achou que se esconderia de um deus?"
"[english]dota_chatwheel_message_zuus_5"	"Did you think you could hide from a god?"
"dota_chatwheel_label_zuus_5"	"Você achou que se esconderia?"
"[english]dota_chatwheel_label_zuus_5"	"Did you think you could hide?"
"dota_chatwheel_message_kunkka_laugh"	"He-hu-hu-hu-hu-huhhuha!"
"[english]dota_chatwheel_message_kunkka_laugh"	"He-hu-hu-hu-hu-huhhuha!"
"dota_chatwheel_label_kunkka_laugh"	"[Risada]"
"[english]dota_chatwheel_label_kunkka_laugh"	"Laugh"
"dota_chatwheel_message_kunkka_thank"	"Você é uma boa companhia!"
"[english]dota_chatwheel_message_kunkka_thank"	"You're a trusty mate!"
"dota_chatwheel_label_kunkka_thank"	"Você é uma boa companhia!"
"[english]dota_chatwheel_label_kunkka_thank"	"You're a trusty mate!"
"dota_chatwheel_message_kunkka_deny"	"Pro fundo do mar!"
"[english]dota_chatwheel_message_kunkka_deny"	"Straight to the bottom with ya!"
"dota_chatwheel_label_kunkka_deny"	"Pro fundo do mar!"
"[english]dota_chatwheel_label_kunkka_deny"	"Straight to the bottom with ya!"
"dota_chatwheel_message_kunkka_2"	"Heh! Homem ao mar!"
"[english]dota_chatwheel_message_kunkka_2"	"Heh! Man overboard!"
"dota_chatwheel_label_kunkka_2"	"Heh! Homem ao mar!"
"[english]dota_chatwheel_label_kunkka_2"	"Heh! Man overboard!"
"dota_chatwheel_message_kunkka_3"	"Você levou uma lavada!"
"[english]dota_chatwheel_message_kunkka_3"	"You're all washed up!"
"dota_chatwheel_label_kunkka_3"	"Você levou uma lavada!"
"[english]dota_chatwheel_label_kunkka_3"	"You're all washed up!"
"dota_chatwheel_label_kunkka_4"	"Só pra deixar claro..."
"[english]dota_chatwheel_label_kunkka_4"	"Just to be clear..."
"dota_chatwheel_message_kunkka_5"	"Você embarcou para a derrota."
"[english]dota_chatwheel_message_kunkka_5"	"You set sail for fail."
"dota_chatwheel_label_kunkka_5"	"Você embarcou para a derrota."
"[english]dota_chatwheel_label_kunkka_5"	"You set sail for fail."
"dota_chatwheel_message_lina_laugh"	"Ha ha ha ha ha ha ha!"
"[english]dota_chatwheel_message_lina_laugh"	"Ha ha ha ha ha ha ha!"
"dota_chatwheel_label_lina_laugh"	"[Risada]"
"[english]dota_chatwheel_label_lina_laugh"	"Laugh"
"dota_chatwheel_message_lina_thank"	"Isso foi quente!"
"[english]dota_chatwheel_message_lina_thank"	"That was hot!"
"dota_chatwheel_label_lina_thank"	"Isso foi quente!"
"[english]dota_chatwheel_label_lina_thank"	"That was hot!"
"dota_chatwheel_message_lina_deny"	"Queima, não é mesmo?"
"[english]dota_chatwheel_message_lina_deny"	"Burns, doesn't it?"
"dota_chatwheel_label_lina_deny"	"Queima, não é mesmo?"
"[english]dota_chatwheel_label_lina_deny"	"Burns, doesn't it?"
"dota_chatwheel_message_lina_1"	"Isso não foi muito brilhante."
"[english]dota_chatwheel_message_lina_1"	"That wasn't too bright."
"dota_chatwheel_label_lina_1"	"Isso não foi muito brilhante."
"[english]dota_chatwheel_label_lina_1"	"That wasn't too bright."
"dota_chatwheel_message_lina_2"	"Você quer brincar com fogo?"
"[english]dota_chatwheel_message_lina_2"	"Wanna play with fire?"
"dota_chatwheel_label_lina_2"	"Você quer brincar com fogo?"
"[english]dota_chatwheel_label_lina_2"	"Wanna play with fire?"
"dota_chatwheel_message_lina_3"	"Que imprestável."
"[english]dota_chatwheel_message_lina_3"	"What a punk."
"dota_chatwheel_label_lina_3"	"Que imprestável."
"[english]dota_chatwheel_label_lina_3"	"What a punk."
"dota_chatwheel_message_lina_5"	"Vem pra mamãe!"
"[english]dota_chatwheel_message_lina_5"	"Come to mama!"
"dota_chatwheel_label_lina_5"	"Vem pra mamãe!"
"[english]dota_chatwheel_label_lina_5"	"Come to mama!"
"dota_chatwheel_message_lion_laugh"	"Who-ha-ha-ha-ha-ha-ha-he-hawha!"
"[english]dota_chatwheel_message_lion_laugh"	"Who-ha-ha-ha-ha-ha-ha-he-hawha!"
"dota_chatwheel_label_lion_laugh"	"[Risada]"
"[english]dota_chatwheel_label_lion_laugh"	"Laugh"
"dota_chatwheel_message_lion_thank"	"Oh, aí sim."
"[english]dota_chatwheel_message_lion_thank"	"Oh, hell yes."
"dota_chatwheel_label_lion_thank"	"Oh, aí sim."
"[english]dota_chatwheel_label_lion_thank"	"Oh, hell yes."
"dota_chatwheel_message_lion_deny"	"Ah, não queria desapontar."
"[english]dota_chatwheel_message_lion_deny"	"Ah, sorry to disappoint you."
"dota_chatwheel_label_lion_deny"	"Ah, não queria desapontar."
"[english]dota_chatwheel_label_lion_deny"	"Ah, sorry to disappoint you."
"dota_chatwheel_message_lion_1"	"Você queria domar o leão?"
"[english]dota_chatwheel_message_lion_1"	"You thought to tame the lion?"
"dota_chatwheel_label_lion_1"	"Você queria domar o leão?"
"[english]dota_chatwheel_label_lion_1"	"You thought to tame the lion?"
"dota_chatwheel_message_lion_2"	"Sinta a fúria de um mago!"
"[english]dota_chatwheel_message_lion_2"	"Feel the rage of a mage!"
"dota_chatwheel_label_lion_2"	"Sinta a fúria de um mago!"
"[english]dota_chatwheel_label_lion_2"	"Feel the rage of a mage!"
"dota_chatwheel_message_lion_3"	"Vá para o inferno!"
"[english]dota_chatwheel_message_lion_3"	"To hell with you!"
"dota_chatwheel_label_lion_3"	"Vá para o inferno!"
"[english]dota_chatwheel_label_lion_3"	"To hell with you!"
"dota_chatwheel_message_lion_4"	"Eu tenho um toque mágico."
"[english]dota_chatwheel_message_lion_4"	"I've got the magic touch."
"dota_chatwheel_label_lion_4"	"Eu tenho um toque mágico."
"[english]dota_chatwheel_label_lion_4"	"I've got the magic touch."
"dota_chatwheel_message_lion_5"	"Eu fui ao inferno e voltei, e voltei ao inferno... e voltei."
"[english]dota_chatwheel_message_lion_5"	"I've been to hell and back, and back to hell...and back."
"dota_chatwheel_label_lion_5"	"Eu fui ao inferno e voltei..."
"[english]dota_chatwheel_label_lion_5"	"I've been to hell and back..."
"dota_chatwheel_message_shadow_shaman_laugh"	"Ha ha ha!"
"[english]dota_chatwheel_message_shadow_shaman_laugh"	"Ha ha ha!"
"dota_chatwheel_label_shadow_shaman_laugh"	"[Risada]"
"[english]dota_chatwheel_label_shadow_shaman_laugh"	"Laugh"
"dota_chatwheel_message_shadow_shaman_thank"	"Minhas preces foram atendidas."
"[english]dota_chatwheel_message_shadow_shaman_thank"	"My prayers are answered."
"dota_chatwheel_label_shadow_shaman_thank"	"Minhas preces foram atendidas."
"[english]dota_chatwheel_label_shadow_shaman_thank"	"My prayers are answered."
"dota_chatwheel_message_shadow_shaman_deny"	"Có, có, có, có!"
"[english]dota_chatwheel_message_shadow_shaman_deny"	"Bukaw, bukaw!"
"dota_chatwheel_label_shadow_shaman_deny"	"Có, có, có, có!"
"[english]dota_chatwheel_label_shadow_shaman_deny"	"Bukaw, bukaw!"
"dota_chatwheel_message_shadow_shaman_1"	"Eu vejo o seu futuro, e está cheio de morte!"
"[english]dota_chatwheel_message_shadow_shaman_1"	"I see for you a future full of death!"
"dota_chatwheel_label_shadow_shaman_1"	"Eu vejo o seu futuro..."
"[english]dota_chatwheel_label_shadow_shaman_1"	"I see for you a future..."
"dota_chatwheel_message_shadow_shaman_2"	"Você não vai a lugar algum."
"[english]dota_chatwheel_message_shadow_shaman_2"	"You're not going anywhere."
"dota_chatwheel_label_shadow_shaman_2"	"Você não vai a lugar algum."
"[english]dota_chatwheel_label_shadow_shaman_2"	"You're not going anywhere."
"dota_chatwheel_message_shadow_shaman_3"	"Heh ha ha hah, que refrescante!"
"[english]dota_chatwheel_message_shadow_shaman_3"	"Heh ha ha hah, how refreshing!"
"dota_chatwheel_label_shadow_shaman_3"	"Heh ha ha hah, que refrescante!"
"[english]dota_chatwheel_label_shadow_shaman_3"	"Heh ha ha hah, how refreshing!"
"dota_chatwheel_message_shadow_shaman_4"	"Tem gosto de galinha!"
"[english]dota_chatwheel_message_shadow_shaman_4"	"Tastes like chicken!"
"dota_chatwheel_label_shadow_shaman_4"	"Tem gosto de galinha!"
"[english]dota_chatwheel_label_shadow_shaman_4"	"Tastes like chicken!"
"dota_chatwheel_message_shadow_shaman_5"	"Au-mosu-atikanu!"
"[english]dota_chatwheel_message_shadow_shaman_5"	"Au-mosu-atikanu!"
"dota_chatwheel_label_shadow_shaman_5"	"Au-mosu-atikanu!"
"[english]dota_chatwheel_label_shadow_shaman_5"	"Au-mosu-atikanu!"
"dota_chatwheel_message_slardar_laugh"	"Heh heeh heh hah hah ha hah hah!"
"[english]dota_chatwheel_message_slardar_laugh"	"Heh heeh heh hah hah ha hah hah!"
"dota_chatwheel_label_slardar_laugh"	"[Risada]"
"[english]dota_chatwheel_label_slardar_laugh"	"Laugh"
"dota_chatwheel_message_slardar_deny"	"Meus pêsames."
"[english]dota_chatwheel_message_slardar_deny"	"My deepest sympathies."
"dota_chatwheel_label_slardar_deny"	"Meus pêsames."
"[english]dota_chatwheel_label_slardar_deny"	"My deepest sympathies."
"dota_chatwheel_message_slardar_1"	"Eu vim de longe para ver você morrer."
"[english]dota_chatwheel_message_slardar_1"	"I came a long way to see you die."
"dota_chatwheel_label_slardar_1"	"Eu vim de longe..."
"[english]dota_chatwheel_label_slardar_1"	"I came a long way..."
"dota_chatwheel_message_slardar_2"	"Você não escapará."
"[english]dota_chatwheel_message_slardar_2"	"You won't escape."
"dota_chatwheel_label_slardar_2"	"Você não escapará."
"[english]dota_chatwheel_label_slardar_2"	"You won't escape."
"dota_chatwheel_message_slardar_3"	"Mais um."
"[english]dota_chatwheel_message_slardar_3"	"Jig's up."
"dota_chatwheel_label_slardar_3"	"Mais um."
"[english]dota_chatwheel_label_slardar_3"	"Jig's up."
"dota_chatwheel_message_slardar_4"	"Aqui não dá pé para você."
"[english]dota_chatwheel_message_slardar_4"	"You were out of your depth."
"dota_chatwheel_label_slardar_4"	"Aqui não dá pé para você."
"[english]dota_chatwheel_label_slardar_4"	"You were out of your depth."
"dota_chatwheel_message_slardar_5"	"Ah, como os profundos festejarão!"
"[english]dota_chatwheel_message_slardar_5"	"Oh, how the deep ones will feast!"
"dota_chatwheel_label_slardar_5"	"Ah, como os profundos festejarão!"
"[english]dota_chatwheel_label_slardar_5"	"Oh, how the deep ones will feast!"
"dota_chatwheel_message_tidehunter_laugh"	"Ah ha ha ha!"
"[english]dota_chatwheel_message_tidehunter_laugh"	"Ah ha ha ha!"
"dota_chatwheel_label_tidehunter_laugh"	"[Risada]"
"[english]dota_chatwheel_label_tidehunter_laugh"	"Laugh"
"dota_chatwheel_message_tidehunter_thank"	"Nós vamos virar essa maré ao nosso favor."
"[english]dota_chatwheel_message_tidehunter_thank"	"We'll turn this tide to our advantage."
"dota_chatwheel_label_tidehunter_thank"	"Nós vamos virar essa maré ao nosso favor."
"[english]dota_chatwheel_label_tidehunter_thank"	"We'll turn this tide to our advantage."
"dota_chatwheel_message_tidehunter_deny"	"Você parece devastado."
"[english]dota_chatwheel_message_tidehunter_deny"	"You look ravaged."
"dota_chatwheel_label_tidehunter_deny"	"Você parece devastado."
"[english]dota_chatwheel_label_tidehunter_deny"	"You look ravaged."
"dota_chatwheel_message_tidehunter_1"	"Ha ha ha ha ha ha, você virou ração de peixe."
"[english]dota_chatwheel_message_tidehunter_1"	"Ha ha ha ha ha ha, Now you're fish food."
"dota_chatwheel_label_tidehunter_1"	"Você virou ração de peixe."
"[english]dota_chatwheel_label_tidehunter_1"	"Now you're fish food."
"dota_chatwheel_message_tidehunter_2"	"Ha ha, eu poderia comer uma morsa."
"[english]dota_chatwheel_message_tidehunter_2"	"Ha ha I could eat a walrus."
"dota_chatwheel_label_tidehunter_2"	"Ha ha, eu poderia comer uma morsa."
"[english]dota_chatwheel_label_tidehunter_2"	"Ha ha I could eat a walrus."
"dota_chatwheel_message_tidehunter_3"	"Coloca uma rolha nisso."
"[english]dota_chatwheel_message_tidehunter_3"	"Put a cork in it."
"dota_chatwheel_label_tidehunter_3"	"Coloca uma rolha nisso."
"[english]dota_chatwheel_label_tidehunter_3"	"Put a cork in it."
"dota_chatwheel_message_tidehunter_4"	"Você pensou que eu erraria? Você deve estar me confundindo com Kunkka."
"[english]dota_chatwheel_message_tidehunter_4"	"Did you think I'd blunder? You must have mistaken me for Kunkka."
"dota_chatwheel_label_tidehunter_4"	"Você pensou que eu erraria?..."
"[english]dota_chatwheel_label_tidehunter_4"	"Did you think I'd blunder?..."
"dota_chatwheel_message_tidehunter_5"	"Quem precisa de um cérebro grande quando se tem dentes como os meus?"
"[english]dota_chatwheel_message_tidehunter_5"	"Who needs a big brain when you've got teeth like mine?"
"dota_chatwheel_label_tidehunter_5"	"Quem precisa de um cérebro grande...?"
"[english]dota_chatwheel_label_tidehunter_5"	"Who needs a big brain...?"
"dota_chatwheel_message_witch_doctor_laugh"	"Hoo hah hoo hoo hah."
"[english]dota_chatwheel_message_witch_doctor_laugh"	"Hoo hah hoo hoo hah."
"dota_chatwheel_label_witch_doctor_laugh"	"[Risada]"
"[english]dota_chatwheel_label_witch_doctor_laugh"	"Laugh"
"dota_chatwheel_message_witch_doctor_deny"	"Fica olhando... Fica olhando..."
"[english]dota_chatwheel_message_witch_doctor_deny"	"Wait for it...wait for it..."
"dota_chatwheel_label_witch_doctor_deny"	"Fica olhando... Fica olhando..."
"[english]dota_chatwheel_label_witch_doctor_deny"	"Wait for it...wait for it..."
"dota_chatwheel_message_witch_doctor_1"	"Isso fez um grande estrago."
"[english]dota_chatwheel_message_witch_doctor_1"	"Dat make a big mess."
"dota_chatwheel_label_witch_doctor_1"	"Isso fez um grande estrago."
"[english]dota_chatwheel_label_witch_doctor_1"	"Dat make a big mess."
"dota_chatwheel_message_witch_doctor_2"	"Alguém chamou o médico?"
"[english]dota_chatwheel_message_witch_doctor_2"	"Someone call de doctor?"
"dota_chatwheel_label_witch_doctor_2"	"Alguém chamou o médico?"
"[english]dota_chatwheel_label_witch_doctor_2"	"Someone call de doctor?"
"dota_chatwheel_message_lich_laugh"	"Ha ha ha ha ha ha ha ha!"
"[english]dota_chatwheel_message_lich_laugh"	"Ha ha ha ha ha ha ha ha!"
"dota_chatwheel_label_lich_laugh"	"[Risada]"
"[english]dota_chatwheel_label_lich_laugh"	"Laugh"
"dota_chatwheel_message_lich_thank"	"Fique frio!"
"[english]dota_chatwheel_message_lich_thank"	"Stay frosty!"
"dota_chatwheel_label_lich_thank"	"Fique frio!"
"[english]dota_chatwheel_label_lich_thank"	"Stay frosty!"
"dota_chatwheel_label_lich_deny"	"Olhe por onde anda..."
"[english]dota_chatwheel_label_lich_deny"	"Watch your step..."
"dota_chatwheel_message_lich_1"	"Não dá para matar os mortos."
"[english]dota_chatwheel_message_lich_1"	"Can't kill the dead."
"dota_chatwheel_label_lich_1"	"Não dá para matar os mortos."
"[english]dota_chatwheel_label_lich_1"	"Can't kill the dead."
"dota_chatwheel_message_lich_4"	"Quem é o número um agora?"
"[english]dota_chatwheel_message_lich_4"	"Who's the number one now?"
"dota_chatwheel_label_lich_4"	"Quem é o número um agora?"
"[english]dota_chatwheel_label_lich_4"	"Who's the number one now?"
"dota_chatwheel_message_lich_5"	"Ah, Ice Frog!"
"[english]dota_chatwheel_message_lich_5"	"Ah, Ice Frog!"
"dota_chatwheel_label_lich_5"	"Ah, Ice Frog!"
"[english]dota_chatwheel_label_lich_5"	"Ah, Ice Frog!"
"dota_chatwheel_message_riki_laugh"	"hoo hoo hoo hoo hoo hoo hoo."
"[english]dota_chatwheel_message_riki_laugh"	"hoo hoo hoo hoo hoo hoo hoo."
"dota_chatwheel_label_riki_laugh"	"[Risada]"
"[english]dota_chatwheel_label_riki_laugh"	"Laugh"
"dota_chatwheel_message_riki_thank"	"Contrato cumprido."
"[english]dota_chatwheel_message_riki_thank"	"Contract complete."
"dota_chatwheel_label_riki_thank"	"Contrato cumprido."
"[english]dota_chatwheel_label_riki_thank"	"Contract complete."
"dota_chatwheel_message_riki_deny"	"Heh-ho, você não esperava por essa."
"[english]dota_chatwheel_message_riki_deny"	"Heh-ho, you didn't see that coming."
"dota_chatwheel_label_riki_deny"	"Você não esperava por essa."
"[english]dota_chatwheel_label_riki_deny"	"You didn't see that coming."
"dota_chatwheel_message_riki_1"	"Pra que adiar o inevitável?"
"[english]dota_chatwheel_message_riki_1"	"Why prolong the inevitable?"
"dota_chatwheel_label_riki_1"	"Pra que adiar o inevitável?"
"[english]dota_chatwheel_label_riki_1"	"Why prolong the inevitable?"
"dota_chatwheel_message_riki_2"	"Cadê? Achou!"
"[english]dota_chatwheel_message_riki_2"	"Peek-a-boo."
"dota_chatwheel_label_riki_2"	"Achou."
"[english]dota_chatwheel_label_riki_2"	"Peek-aboo."
"dota_chatwheel_message_riki_3"	"Se você pode me ver, você já era."
"[english]dota_chatwheel_message_riki_3"	"If you can see me, you're already dead."
"dota_chatwheel_label_riki_3"	"Se você pode me ver..."
"[english]dota_chatwheel_label_riki_3"	"If you can see me..."
"dota_chatwheel_message_riki_4"	"Eu estava aqui o tempo todo."
"[english]dota_chatwheel_message_riki_4"	"I've been here the whole time."
"dota_chatwheel_label_riki_4"	"Eu estava aqui o tempo todo."
"[english]dota_chatwheel_label_riki_4"	"I've been here the whole time."
"dota_chatwheel_message_enigma_laugh"	"He-he-huh-heh-heh."
"[english]dota_chatwheel_message_enigma_laugh"	"He-he-huh-heh-heh."
"dota_chatwheel_label_enigma_laugh"	"[Risada]"
"[english]dota_chatwheel_label_enigma_laugh"	"Laugh"
"dota_chatwheel_message_enigma_thank"	"Bem, isso é um paradoxo."
"[english]dota_chatwheel_message_enigma_thank"	"Well, this is a paradox."
"dota_chatwheel_label_enigma_thank"	"Bem, isso é um paradoxo."
"[english]dota_chatwheel_label_enigma_thank"	"Well, this is a paradox."
"dota_chatwheel_message_enigma_deny"	"Um preço astronômico."
"[english]dota_chatwheel_message_enigma_deny"	"An astronomical price."
"dota_chatwheel_label_enigma_deny"	"Um preço astronômico."
"[english]dota_chatwheel_label_enigma_deny"	"An astronomical price."
"dota_chatwheel_message_enigma_1"	"Olhe para o abismo."
"[english]dota_chatwheel_message_enigma_1"	"Stare into the abyss."
"dota_chatwheel_label_enigma_1"	"Olhe para o abismo."
"[english]dota_chatwheel_label_enigma_1"	"Stare into the abyss."
"dota_chatwheel_message_enigma_2"	"O silêncio vale ouro."
"[english]dota_chatwheel_message_enigma_2"	"Silence is golden."
"dota_chatwheel_label_enigma_2"	"O silêncio vale ouro."
"[english]dota_chatwheel_label_enigma_2"	"Silence is golden."
"dota_chatwheel_message_enigma_5"	"Se a luz não me escapa, quais são as suas chances?"
"[english]dota_chatwheel_message_enigma_5"	"If light cannot escape me, what hope have you?"
"dota_chatwheel_label_enigma_5"	"Se a luz não me escapa..."
"[english]dota_chatwheel_label_enigma_5"	"If light cannot escape me..."
"dota_chatwheel_message_tinker_laugh"	"Ah ha ha ha ha!"
"[english]dota_chatwheel_message_tinker_laugh"	"Ah ha ha ha ha!"
"dota_chatwheel_label_tinker_laugh"	"[Risada]"
"[english]dota_chatwheel_label_tinker_laugh"	"Laugh"
"dota_chatwheel_message_tinker_2"	"Saiba que eu previ isso tudo, tudo mesmo!"
"[english]dota_chatwheel_message_tinker_2"	"I predicted all of this you know, all of it!"
"dota_chatwheel_label_tinker_2"	"Saiba que eu previ isso tudo..."
"[english]dota_chatwheel_label_tinker_2"	"I predicted all of this you know..."
"dota_chatwheel_message_tinker_3"	"Isso foi genial!"
"[english]dota_chatwheel_message_tinker_3"	"That was genius!"
"dota_chatwheel_label_tinker_3"	"Isso foi genial!"
"[english]dota_chatwheel_label_tinker_3"	"That was genius!"
"dota_chatwheel_message_tinker_5"	"Pode ficar com os seus truques, eu tenho raios laser!"
"[english]dota_chatwheel_message_tinker_5"	"You can keep your magic, I have laser beams!"
"dota_chatwheel_label_tinker_5"	"Pode ficar com os seus truques..."
"[english]dota_chatwheel_label_tinker_5"	"You can keep your magic..."
"dota_chatwheel_message_sniper_laugh"	"Hee hee hee hee hee hee hee hee hee hee!"
"[english]dota_chatwheel_message_sniper_laugh"	"Hee hee hee hee hee hee hee hee hee hee!"
"dota_chatwheel_label_sniper_laugh"	"[Risada]"
"[english]dota_chatwheel_label_sniper_laugh"	"Laugh"
"dota_chatwheel_message_sniper_deny"	"Mas o quê—?"
"[english]dota_chatwheel_message_sniper_deny"	"What the---?"
"dota_chatwheel_label_sniper_deny"	"Mas o quê—?"
"[english]dota_chatwheel_label_sniper_deny"	"What the---?"
"dota_chatwheel_message_sniper_1"	"Diga adeus à sua cabeça!"
"[english]dota_chatwheel_message_sniper_1"	"Say goodbye to your head!"
"dota_chatwheel_label_sniper_1"	"Diga adeus à sua cabeça!"
"[english]dota_chatwheel_label_sniper_1"	"Say goodbye to your head!"
"dota_chatwheel_message_sniper_2"	"Dance! Ha ha ha ha! Dance!"
"[english]dota_chatwheel_message_sniper_2"	"Dance! Ha ha ha ha! Dance!"
"dota_chatwheel_label_sniper_2"	"Dance! Ha ha ha ha! Dance!"
"[english]dota_chatwheel_label_sniper_2"	"Dance! Ha ha ha ha! Dance!"
"dota_chatwheel_label_sniper_3"	"Por que estou sorrindo?..."
"[english]dota_chatwheel_label_sniper_3"	"Why am I smiling?..."
"dota_chatwheel_message_necrolyte_laugh"	"Ha ha ha ha ha ha ha ha ha ha ha ha!"
"[english]dota_chatwheel_message_necrolyte_laugh"	"Ha ha ha ha ha ha ha ha ha ha ha ha!"
"dota_chatwheel_label_necrolyte_laugh"	"[Risada]"
"[english]dota_chatwheel_label_necrolyte_laugh"	"Laugh"
"dota_chatwheel_message_necrolyte_thank"	"Respire fundo."
"[english]dota_chatwheel_message_necrolyte_thank"	"Breathe it in."
"dota_chatwheel_label_necrolyte_thank"	"Respire fundo."
"[english]dota_chatwheel_label_necrolyte_thank"	"Breathe it in."
"dota_chatwheel_message_necrolyte_deny"	"Isso custou caro."
"[english]dota_chatwheel_message_necrolyte_deny"	"That was costly."
"dota_chatwheel_label_necrolyte_deny"	"Isso custou caro."
"[english]dota_chatwheel_label_necrolyte_deny"	"That was costly."
"dota_chatwheel_message_necrolyte_3"	"Tudo apodreceu."
"[english]dota_chatwheel_message_necrolyte_3"	"It's all gone rotten."
"dota_chatwheel_label_necrolyte_3"	"Tudo apodreceu."
"[english]dota_chatwheel_label_necrolyte_3"	"It's all gone rotten."
"dota_chatwheel_label_necrolyte_5"	"Eu sou aquele que estraga tudo."
"[english]dota_chatwheel_label_necrolyte_5"	"I am the rotten apple..."
"dota_chatwheel_label_warlock_laugh"	"[Risada]"
"[english]dota_chatwheel_label_warlock_laugh"	"Laugh"
"dota_chatwheel_message_warlock_4"	"Tampinha."
"[english]dota_chatwheel_message_warlock_4"	"Pipsqueak."
"dota_chatwheel_label_warlock_4"	"Tampinha."
"[english]dota_chatwheel_label_warlock_4"	"Pipsqueak."
"dota_chatwheel_label_beastmaster_laugh"	"[Risada]"
"[english]dota_chatwheel_label_beastmaster_laugh"	"Laugh"
"dota_chatwheel_label_queenofpain_laugh"	"[Risada]"
"[english]dota_chatwheel_label_queenofpain_laugh"	"Laugh"
"dota_chatwheel_message_queenofpain_thank"	"Haverá dor e gritos."
"[english]dota_chatwheel_message_queenofpain_thank"	"There will be pain, there will be screaming."
"dota_chatwheel_message_queenofpain_2"	"Isso dói?"
"[english]dota_chatwheel_message_queenofpain_2"	"Does this hurt?"
"dota_chatwheel_label_queenofpain_2"	"Isso dói?"
"[english]dota_chatwheel_label_queenofpain_2"	"Does this hurt?"
"dota_chatwheel_message_queenofpain_3"	"Eu adoro quando você resiste."
"[english]dota_chatwheel_message_queenofpain_3"	"I love it when you resist."
"dota_chatwheel_label_queenofpain_3"	"Eu adoro quando você resiste."
"[english]dota_chatwheel_label_queenofpain_3"	"I love it when you resist."
"dota_chatwheel_label_venomancer_laugh"	"[Risada]"
"[english]dota_chatwheel_label_venomancer_laugh"	"Laugh"
"dota_chatwheel_message_venomancer_thank"	"Aflija os nossos inimigos!"
"[english]dota_chatwheel_message_venomancer_thank"	"Plague our enemies!"
"dota_chatwheel_label_venomancer_thank"	"Aflija os nossos inimigos!"
"[english]dota_chatwheel_label_venomancer_thank"	"Plague our enemies!"
"dota_chatwheel_label_faceless_void_laugh"	"[Risada]"
"[english]dota_chatwheel_label_faceless_void_laugh"	"Laugh"
"dota_chatwheel_label_death_prophet_laugh"	"[Risada]"
"[english]dota_chatwheel_label_death_prophet_laugh"	"Laugh"
"dota_chatwheel_label_phantom_assassin_laugh"	"[Risada]"
"[english]dota_chatwheel_label_phantom_assassin_laugh"	"Laugh"
"dota_chatwheel_label_phantom_assassin_4"	"[Risada]... não não não."
"[english]dota_chatwheel_label_phantom_assassin_4"	"Laugh...no no no."
"dota_chatwheel_label_pugna_laugh"	"[Risada]"
"[english]dota_chatwheel_label_pugna_laugh"	"Laugh"
"dota_chatwheel_label_pugna_2"	"Sentiram a minha falta?"
"[english]dota_chatwheel_label_pugna_2"	"Anyone miss me?"
"dota_chatwheel_label_templar_assassin_laugh"	"[Risada]"
"[english]dota_chatwheel_label_templar_assassin_laugh"	"Laugh"
"dota_chatwheel_message_templar_assassin_1"	"Eles nunca encontrarão a sua cova."
"[english]dota_chatwheel_message_templar_assassin_1"	"They'll never find your grave."
"dota_chatwheel_label_templar_assassin_1"	"Eles nunca encontrarão a sua cova."
"[english]dota_chatwheel_label_templar_assassin_1"	"They'll never find your grave."
"dota_chatwheel_message_templar_assassin_2"	"É uma cilada!"
"[english]dota_chatwheel_message_templar_assassin_2"	"It's a trap!"
"dota_chatwheel_label_templar_assassin_2"	"É uma cilada!"
"[english]dota_chatwheel_label_templar_assassin_2"	"It's a trap!"
"dota_chatwheel_label_viper_laugh"	"[Risada]"
"[english]dota_chatwheel_label_viper_laugh"	"Laugh"
"dota_chatwheel_label_luna_laugh"	"[Risada]"
"[english]dota_chatwheel_label_luna_laugh"	"Laugh"
"dota_chatwheel_label_dragon_knight_laugh"	"[Risada]"
"[english]dota_chatwheel_label_dragon_knight_laugh"	"Laugh"
"dota_chatwheel_message_dragon_knight_5"	"Enfrente o cavaleiro, enfrente o dragão."
"[english]dota_chatwheel_message_dragon_knight_5"	"Face the knight, face the dragon."
"dota_chatwheel_label_dragon_knight_5"	"Enfrente o cavaleiro, enfrente o dragão."
"[english]dota_chatwheel_label_dragon_knight_5"	"Face the knight, face the dragon."
"dota_chatwheel_label_dazzle_laugh"	"[Risada]"
"[english]dota_chatwheel_label_dazzle_laugh"	"Laugh"
"dota_chatwheel_message_dazzle_2"	"Gentil de sua parte."
"[english]dota_chatwheel_message_dazzle_2"	"Charitable of you."
"dota_chatwheel_label_dazzle_2"	"Gentil de sua parte."
"[english]dota_chatwheel_label_dazzle_2"	"Charitable of you."
"dota_chatwheel_label_rattletrap_laugh"	"[Risada]"
"[english]dota_chatwheel_label_rattletrap_laugh"	"Laugh"
"dota_chatwheel_message_rattletrap_1"	"Me diga que alguém viu isso!"
"[english]dota_chatwheel_message_rattletrap_1"	"Tell me someone saw that!"
"dota_chatwheel_label_rattletrap_1"	"Me diga que alguém viu isso!"
"[english]dota_chatwheel_label_rattletrap_1"	"Tell me someone saw that!"
"dota_chatwheel_message_rattletrap_3"	"Uou!"
"[english]dota_chatwheel_message_rattletrap_3"	"Whoa!"
"dota_chatwheel_label_rattletrap_3"	"Uou!"
"[english]dota_chatwheel_label_rattletrap_3"	"Whoa!"
"dota_chatwheel_label_leshrac_laugh"	"[Risada]"
"[english]dota_chatwheel_label_leshrac_laugh"	"Laugh"
"dota_chatwheel_label_furion_laugh"	"[Risada]"
"[english]dota_chatwheel_label_furion_laugh"	"Laugh"
"dota_chatwheel_label_life_stealer_laugh"	"[Risada]"
"[english]dota_chatwheel_label_life_stealer_laugh"	"Laugh"
"dota_chatwheel_label_life_stealer_3"	"Doce violência."
"[english]dota_chatwheel_label_life_stealer_3"	"Sweet, sweet violence."
"dota_chatwheel_message_life_stealer_4"	"Você sente a mão vermelha da morte."
"[english]dota_chatwheel_message_life_stealer_4"	"You feel the red hand of death."
"dota_chatwheel_label_dark_seer_laugh"	"[Risada]"
"[english]dota_chatwheel_label_dark_seer_laugh"	"Laugh"
"dota_chatwheel_label_dark_seer_2"	"Não acredito que deu certo!"
"[english]dota_chatwheel_label_dark_seer_2"	"I cannot believe that worked!"
"dota_chatwheel_label_clinkz_laugh"	"[Risada]"
"[english]dota_chatwheel_label_clinkz_laugh"	"Laugh"
"dota_chatwheel_message_clinkz_5"	"Quanto mais alimentado, mais faminto o fogo fica."
"[english]dota_chatwheel_message_clinkz_5"	"Fire grows hungrier the more it's fed."
"dota_chatwheel_message_omniknight_laugh"	"Muh-ha-ha-ha-ha-ha-ha."
"[english]dota_chatwheel_message_omniknight_laugh"	"Mehooweheh hwh hew."
"dota_chatwheel_label_omniknight_laugh"	"[Risada]"
"[english]dota_chatwheel_label_omniknight_laugh"	"Laugh"
"dota_chatwheel_message_omniknight_deny"	"Na mosca."
"[english]dota_chatwheel_message_omniknight_deny"	"Nailed it."
"dota_chatwheel_label_omniknight_deny"	"Na mosca."
"[english]dota_chatwheel_label_omniknight_deny"	"Nailed it."
"dota_chatwheel_label_enchantress_laugh"	"[Risada]"
"[english]dota_chatwheel_label_enchantress_laugh"	"Laugh"
"dota_chatwheel_message_enchantress_thank"	"Eu adoro vencer!"
"[english]dota_chatwheel_message_enchantress_thank"	"I love winning!"
"dota_chatwheel_label_enchantress_thank"	"Eu adoro vencer!"
"[english]dota_chatwheel_label_enchantress_thank"	"I love winning!"
"dota_chatwheel_message_enchantress_5"	"Sabe o que eu adoro? Tudo!"
"[english]dota_chatwheel_message_enchantress_5"	"You know what I love? Everything!"
"dota_chatwheel_label_enchantress_5"	"Sabe o que eu adoro?..."
"[english]dota_chatwheel_label_enchantress_5"	"You know what I love?..."
"dota_chatwheel_label_huskar_laugh"	"[Risada]"
"[english]dota_chatwheel_label_huskar_laugh"	"Laugh"
"dota_chatwheel_message_huskar_3"	"Agora a minha vida tem sentido!"
"[english]dota_chatwheel_message_huskar_3"	"My life now has meaning!"
"dota_chatwheel_label_huskar_3"	"Agora a minha vida tem sentido!"
"[english]dota_chatwheel_label_huskar_3"	"My life now has meaning!"
"dota_chatwheel_label_night_stalker_laugh"	"[Risada]"
"[english]dota_chatwheel_label_night_stalker_laugh"	"Laugh"
"dota_chatwheel_label_night_stalker_1"	"Justo o que eu precisava."
"[english]dota_chatwheel_label_night_stalker_1"	"Just what I needed."
"dota_chatwheel_message_night_stalker_2"	"Não há escapatória."
"[english]dota_chatwheel_message_night_stalker_2"	"There's no escape."
"dota_chatwheel_label_night_stalker_2"	"Não há escapatória."
"[english]dota_chatwheel_label_night_stalker_2"	"There's no escape."
"dota_chatwheel_message_night_stalker_5"	"Eu sou o monstro das histórias de ninar."
"[english]dota_chatwheel_message_night_stalker_5"	"I'm the beast of bedtime tales."
"dota_chatwheel_label_night_stalker_5"	"Eu sou o monstro das histórias de ninar."
"[english]dota_chatwheel_label_night_stalker_5"	"I'm the beast of bedtime tales."
"dota_chatwheel_label_broodmother_laugh"	"[Risada]"
"[english]dota_chatwheel_label_broodmother_laugh"	"Laugh"
"dota_chatwheel_message_broodmother_1"	"Delícia."
"[english]dota_chatwheel_message_broodmother_1"	"Delicious."
"dota_chatwheel_message_broodmother_3"	"Não morram, meus queridinhos."
"[english]dota_chatwheel_message_broodmother_3"	"Don't die, my darlings."
"dota_chatwheel_label_broodmother_3"	"Não morram, meus queridinhos."
"[english]dota_chatwheel_label_broodmother_3"	"Don't die, my darlings."
"dota_chatwheel_label_bounty_hunter_laugh"	"[Risada]"
"[english]dota_chatwheel_label_bounty_hunter_laugh"	"Laugh"
"dota_chatwheel_message_bounty_hunter_4"	"Você pode correr, mas não pode se esconder."
"[english]dota_chatwheel_message_bounty_hunter_4"	"You can run but you can't hide."
"dota_chatwheel_label_bounty_hunter_4"	"Você pode correr, mas não pode se esconder."
"[english]dota_chatwheel_label_bounty_hunter_4"	"You can run but you can't hide."
"dota_chatwheel_message_bounty_hunter_5"	"Isso ficará na história."
"[english]dota_chatwheel_message_bounty_hunter_5"	"They'll tell tales of this."
"dota_chatwheel_label_bounty_hunter_5"	"Isso ficará na história."
"[english]dota_chatwheel_label_bounty_hunter_5"	"They'll tell tales of this."
"dota_chatwheel_label_weaver_laugh"	"[Risada]"
"[english]dota_chatwheel_label_weaver_laugh"	"Laugh"
"dota_chatwheel_message_weaver_1"	"Sinto um padrão aqui."
"[english]dota_chatwheel_message_weaver_1"	"I'm sensing a pattern here."
"dota_chatwheel_label_weaver_1"	"Sinto que há um padrão."
"[english]dota_chatwheel_label_weaver_1"	"Sensing a pattern."
"dota_chatwheel_label_jakiro_laugh"	"[Risada]"
"[english]dota_chatwheel_label_jakiro_laugh"	"Laugh"
"dota_chatwheel_message_jakiro_thank"	"Saúde."
"[english]dota_chatwheel_message_jakiro_thank"	"Cheers."
"dota_chatwheel_label_jakiro_thank"	"Saúde."
"[english]dota_chatwheel_label_jakiro_thank"	"Cheers."
"dota_chatwheel_message_jakiro_1"	"Incinerado."
"[english]dota_chatwheel_message_jakiro_1"	"Burninated."
"dota_chatwheel_label_jakiro_1"	"Incinerado!"
"[english]dota_chatwheel_label_jakiro_1"	"Burninated!"
"dota_chatwheel_message_jakiro_4"	"Não estamos impressionados."
"[english]dota_chatwheel_message_jakiro_4"	"We are not amused."
"dota_chatwheel_label_jakiro_4"	"Não estamos impressionados."
"[english]dota_chatwheel_label_jakiro_4"	"We are not amused."
"dota_chatwheel_label_batrider_laugh"	"[Risada]"
"[english]dota_chatwheel_label_batrider_laugh"	"Laugh"
"dota_chatwheel_message_batrider_1"	"Indo em direção ao pôr do sol."
"[english]dota_chatwheel_message_batrider_1"	"Aw yeah, off we ride into the sunset."
"dota_chatwheel_label_batrider_1"	"Indo em direção ao pôr do sol!"
"[english]dota_chatwheel_label_batrider_1"	"Into the sunset!"
"dota_chatwheel_label_chen_laugh"	"[Risada]"
"[english]dota_chatwheel_label_chen_laugh"	"Laugh"
"dota_chatwheel_message_spectre_laugh"	"Ha ha ha ha ha ha ha ha ha!"
"[english]dota_chatwheel_message_spectre_laugh"	"Ha ha ha ha ha ha ha ha ha!"
"dota_chatwheel_label_spectre_laugh"	"[Risada]"
"[english]dota_chatwheel_label_spectre_laugh"	"[Laugh]"
"dota_chatwheel_message_spectre_thank"	"Ficarei ao seu lado."
"[english]dota_chatwheel_message_spectre_thank"	"I'll stand by you."
"dota_chatwheel_label_spectre_thank"	"Ficarei ao seu lado."
"[english]dota_chatwheel_label_spectre_thank"	"I'll stand by you."
"dota_chatwheel_message_spectre_deny"	"Errado."
"[english]dota_chatwheel_message_spectre_deny"	"Wrong."
"dota_chatwheel_label_spectre_deny"	"Errado."
"[english]dota_chatwheel_label_spectre_deny"	"Wrong."
"dota_chatwheel_message_spectre_1"	"Eu não entendo."
"[english]dota_chatwheel_message_spectre_1"	"I do not understand."
"dota_chatwheel_label_spectre_1"	"Eu não entendo."
"[english]dota_chatwheel_label_spectre_1"	"I do not understand."
"dota_chatwheel_message_spectre_2"	"O que é isso?"
"[english]dota_chatwheel_message_spectre_2"	"What is this?"
"dota_chatwheel_label_spectre_2"	"O que é isso?"
"[english]dota_chatwheel_label_spectre_2"	"What is this?"
"dota_chatwheel_message_spectre_3"	"Uma habilidade útil."
"[english]dota_chatwheel_message_spectre_3"	"A useful skill."
"dota_chatwheel_label_spectre_3"	"Uma habilidade útil."
"[english]dota_chatwheel_label_spectre_3"	"A useful skill."
"dota_chatwheel_message_spectre_4"	"Será que ninguém me entende?"
"[english]dota_chatwheel_message_spectre_4"	"Can no one understand me?"
"dota_chatwheel_label_spectre_4"	"Será que ninguém me entende?"
"[english]dota_chatwheel_label_spectre_4"	"Can no one understand me?"
"dota_chatwheel_message_spectre_5"	"Miserável e ignorante."
"[english]dota_chatwheel_message_spectre_5"	"Miserable and ignorant."
"dota_chatwheel_label_spectre_5"	"Miserável e ignorante."
"[english]dota_chatwheel_label_spectre_5"	"Miserable and ignorant."
"dota_chatwheel_label_ancient_apparition_laugh"	"[Risada]"
"[english]dota_chatwheel_label_ancient_apparition_laugh"	"Laugh"
"dota_chatwheel_label_doom_bringer_laugh"	"[Risada]"
"[english]dota_chatwheel_label_doom_bringer_laugh"	"Laugh"
"dota_chatwheel_label_ursa_laugh"	"[Risada]"
"[english]dota_chatwheel_label_ursa_laugh"	"Laugh"
"dota_chatwheel_label_ursa_deny"	"Uma perda tão pequena."
"[english]dota_chatwheel_label_ursa_deny"	"A loss so small."
"dota_chatwheel_label_spirit_breaker_laugh"	"[Risada]"
"[english]dota_chatwheel_label_spirit_breaker_laugh"	"Laugh"
"dota_chatwheel_label_gyrocopter_laugh"	"[Risada]"
"[english]dota_chatwheel_label_gyrocopter_laugh"	"Laugh"
"dota_chatwheel_message_gyrocopter_1"	"Sorte a sua!"
"[english]dota_chatwheel_message_gyrocopter_1"	"Lucky!"
"dota_chatwheel_label_gyrocopter_1"	"Sorte a sua!"
"[english]dota_chatwheel_label_gyrocopter_1"	"Lucky!"
"dota_chatwheel_message_gyrocopter_5"	"Eu pertenço ao céu e você ao solo."
"[english]dota_chatwheel_message_gyrocopter_5"	"I belong in the sky, and you belong in the ground."
"dota_chatwheel_label_alchemist_laugh"	"[Risada]"
"[english]dota_chatwheel_label_alchemist_laugh"	"Laugh"
"dota_chatwheel_message_alchemist_thank"	"Nós temos uma ótima química."
"[english]dota_chatwheel_message_alchemist_thank"	"We've got pretty good chemistry."
"dota_chatwheel_message_alchemist_deny"	"Isso foi genial!"
"[english]dota_chatwheel_message_alchemist_deny"	"That was genius!"
"dota_chatwheel_label_alchemist_deny"	"Isso foi genial!"
"[english]dota_chatwheel_label_alchemist_deny"	"That was genius!"
"dota_chatwheel_label_invoker_laugh"	"[Risada]"
"[english]dota_chatwheel_label_invoker_laugh"	"Laugh"
"dota_chatwheel_message_invoker_1"	"Isso foi um chiado?"
"[english]dota_chatwheel_message_invoker_1"	"Did I hear a squeak?"
"dota_chatwheel_label_invoker_1"	"Isso foi um chiado?"
"[english]dota_chatwheel_label_invoker_1"	"Did I hear a squeak?"
"dota_chatwheel_label_silencer_laugh"	"[Risada]"
"[english]dota_chatwheel_label_silencer_laugh"	"Laugh"
"dota_chatwheel_label_obsidian_destroyer_laugh"	"[Risada]"
"[english]dota_chatwheel_label_obsidian_destroyer_laugh"	"Laugh"
"dota_chatwheel_label_obsidian_destroyer_thank"	"O que está por vir."
"[english]dota_chatwheel_label_obsidian_destroyer_thank"	"What is to come."
"dota_chatwheel_label_lycan_laugh"	"[Risada]"
"[english]dota_chatwheel_label_lycan_laugh"	"Laugh"
"dota_chatwheel_label_lycan_deny"	"Tente me matar!"
"[english]dota_chatwheel_label_lycan_deny"	"Just try to kill me!"
"dota_chatwheel_message_lycan_2"	"Sou o lobo alfa."
"[english]dota_chatwheel_message_lycan_2"	"I am the alpha wolf."
"dota_chatwheel_label_brewmaster_laugh"	"[Risada]"
"[english]dota_chatwheel_label_brewmaster_laugh"	"Laugh"
"dota_chatwheel_label_shadow_demon_laugh"	"[Risada]"
"[english]dota_chatwheel_label_shadow_demon_laugh"	"Laugh"
"dota_chatwheel_label_lone_druid_laugh"	"[Risada]"
"[english]dota_chatwheel_label_lone_druid_laugh"	"Laugh"
"dota_chatwheel_label_chaos_knight_laugh"	"[Risada]"
"[english]dota_chatwheel_label_chaos_knight_laugh"	"Laugh"
"dota_chatwheel_label_meepo_laugh"	"[Risada]"
"[english]dota_chatwheel_label_meepo_laugh"	"Laugh"
"dota_chatwheel_label_treant_laugh"	"[Risada]"
"[english]dota_chatwheel_label_treant_laugh"	"Laugh"
"dota_chatwheel_label_ogre_magi_laugh"	"[Risada]"
"[english]dota_chatwheel_label_ogre_magi_laugh"	"Laugh"
"dota_chatwheel_label_undying_laugh"	"[Risada]"
"[english]dota_chatwheel_label_undying_laugh"	"Laugh"
"dota_chatwheel_label_rubick_laugh"	"[Risada]"
"[english]dota_chatwheel_label_rubick_laugh"	"Laugh"
"dota_chatwheel_label_disruptor_laugh"	"[Risada]"
"[english]dota_chatwheel_label_disruptor_laugh"	"Laugh"
"dota_chatwheel_label_nyx_assassin_laugh"	"[Risada]"
"[english]dota_chatwheel_label_nyx_assassin_laugh"	"Laugh"
"dota_chatwheel_label_naga_siren_laugh"	"[Risada]"
"[english]dota_chatwheel_label_naga_siren_laugh"	"Laugh"
"dota_chatwheel_label_keeper_of_the_light_laugh"	"[Risada]"
"[english]dota_chatwheel_label_keeper_of_the_light_laugh"	"Laugh"
"dota_chatwheel_message_keeper_of_the_light_5"	"Não tema a luz — tema a mim!"
"[english]dota_chatwheel_message_keeper_of_the_light_5"	"Do not fear the light - fear me!"
"dota_chatwheel_label_keeper_of_the_light_5"	"Não tema a luz..."
"[english]dota_chatwheel_label_keeper_of_the_light_5"	"Do not fear the light..."
"dota_chatwheel_label_visage_laugh"	"[Risada]"
"[english]dota_chatwheel_label_visage_laugh"	"Laugh"
"dota_chatwheel_label_slark_laugh"	"[Risada]"
"[english]dota_chatwheel_label_slark_laugh"	"Laugh"
"dota_chatwheel_label_slark_thank"	"Eu confio em vocês."
"[english]dota_chatwheel_label_slark_thank"	"I can trust you guys."
"dota_chatwheel_label_slark_deny"	"Fique de bruços..."
"[english]dota_chatwheel_label_slark_deny"	"On your belly"
"dota_chatwheel_label_medusa_laugh"	"[Risada]"
"[english]dota_chatwheel_label_medusa_laugh"	"Laugh"
"dota_chatwheel_label_troll_warlord_laugh"	"[Risada]"
"[english]dota_chatwheel_label_troll_warlord_laugh"	"Laugh"
"dota_chatwheel_label_centaur_laugh"	"[Risada]"
"[english]dota_chatwheel_label_centaur_laugh"	"Laugh"
"dota_chatwheel_label_magnataur_laugh"	"[Risada]"
"[english]dota_chatwheel_label_magnataur_laugh"	"Laugh"
"dota_chatwheel_label_shredder_laugh"	"[Risada]"
"[english]dota_chatwheel_label_shredder_laugh"	"Laugh"
"dota_chatwheel_label_bristleback_laugh"	"[Risada]"
"[english]dota_chatwheel_label_bristleback_laugh"	"Laugh"
"dota_chatwheel_label_tusk_laugh"	"[Risada]"
"[english]dota_chatwheel_label_tusk_laugh"	"Laugh"
"dota_chatwheel_label_skywrath_mage_laugh"	"[Risada]"
"[english]dota_chatwheel_label_skywrath_mage_laugh"	"Laugh"
"dota_chatwheel_label_abaddon_laugh"	"[Risada]"
"[english]dota_chatwheel_label_abaddon_laugh"	"Laugh"
"dota_chatwheel_label_elder_titan_laugh"	"[Risada]"
"[english]dota_chatwheel_label_elder_titan_laugh"	"Laugh"
"dota_chatwheel_label_legion_commander_laugh"	"[Risada]"
"[english]dota_chatwheel_label_legion_commander_laugh"	"Laugh"
"dota_chatwheel_label_techies_laugh"	"[Risada]"
"[english]dota_chatwheel_label_techies_laugh"	"Laugh"
"dota_chatwheel_label_ember_spirit_laugh"	"[Risada]"
"[english]dota_chatwheel_label_ember_spirit_laugh"	"Laugh"
"dota_chatwheel_message_ember_spirit_4"	"A fúria leva ao fracasso."
"[english]dota_chatwheel_message_ember_spirit_4"	"Through anger lies failure."
"dota_chatwheel_label_earth_spirit_laugh"	"[Risada]"
"[english]dota_chatwheel_label_earth_spirit_laugh"	"Laugh"
"dota_chatwheel_message_earth_spirit_5"	"Quem ousa me enfrentar agora?"
"[english]dota_chatwheel_message_earth_spirit_5"	"Who dares face me now."
"dota_chatwheel_label_earth_spirit_5"	"Quem ousa me enfrentar agora?"
"[english]dota_chatwheel_label_earth_spirit_5"	"Who dares face me now."
"dota_chatwheel_label_abyssal_underlord_laugh"	"[Risada]"
"[english]dota_chatwheel_label_abyssal_underlord_laugh"	"Laugh"
"dota_chatwheel_label_terrorblade_laugh"	"[Risada]"
"[english]dota_chatwheel_label_terrorblade_laugh"	"Laugh"
"dota_chatwheel_message_terrorblade_thank"	"Que pedaço de mau caminho."
"[english]dota_chatwheel_message_terrorblade_thank"	"What a handsome devil."
"dota_chatwheel_label_terrorblade_thank"	"Que pedaço de mau caminho."
"[english]dota_chatwheel_label_terrorblade_thank"	"What a handsome devil."
"dota_chatwheel_label_oracle_laugh"	"[Risada]"
"[english]dota_chatwheel_label_oracle_laugh"	"Laugh"
"dota_chatwheel_label_arc_warden_laugh"	"[Risada]"
"[english]dota_chatwheel_label_arc_warden_laugh"	"Laugh"
"dota_chatwheel_label_winter_wyvern_laugh"	"[Risada]"
"[english]dota_chatwheel_label_winter_wyvern_laugh"	"Laugh"
"dota_chatwheel_label_monkey_king_laugh"	"[Risada]"
"[english]dota_chatwheel_label_monkey_king_laugh"	"Laugh"
"dota_chatwheel_label_monkey_king_thank"	"Isso serve."
"[english]dota_chatwheel_label_monkey_king_thank"	"This'll work."
"dota_chatwheel_label_dark_willow_laugh"	"[Risada]"
"[english]dota_chatwheel_label_dark_willow_laugh"	"Laugh"
"dota_chatwheel_label_pangolier_laugh"	"[Risada]"
"[english]dota_chatwheel_label_pangolier_laugh"	"Laugh"
}
