"lang"
{
"Language"	"vietnamese"
"Tokens"
{
"TF_AutoAssign"	"&1 Tự động tham gia"
"[english]TF_AutoAssign"	"&1 AUTO ASSIGN"
"TF_BlueTeam"	"&3 BLU"
"[english]TF_BlueTeam"	"&3 BLU"
"TF_RedTeam"	"&4 RED"
"[english]TF_RedTeam"	"&4 RED"
"TF_Observer"	"Khán giả"
"[english]TF_Observer"	"OBSERVER"
"TF_Random"	"NGẪU NHIÊN"
"[english]TF_Random"	"RANDOM"
"TF_BlueTeam_Name"	"BLU"
"[english]TF_BlueTeam_Name"	"BLU"
"TF_RedTeam_Name"	"RED"
"[english]TF_RedTeam_Name"	"RED"
"TF_Scout"	"SCOUT"
"[english]TF_Scout"	"SCOUT"
"TF_Sniper"	"SNIPER"
"[english]TF_Sniper"	"SNIPER"
"TF_Soldier"	"SOLDIER"
"[english]TF_Soldier"	"SOLDIER"
"TF_Demoman"	"DEMOMAN"
"[english]TF_Demoman"	"DEMOMAN"
"TF_Medic"	"MEDIC"
"[english]TF_Medic"	"MEDIC"
"TF_HWGuy"	"HEAVY"
"[english]TF_HWGuy"	"HEAVY"
"TF_Pyro"	"PYRO"
"[english]TF_Pyro"	"PYRO"
"TF_Spy"	"SPY"
"[english]TF_Spy"	"SPY"
"TF_Engineer"	"ENGINEER"
"[english]TF_Engineer"	"ENGINEER"
"TF_Class_Name_Undefined"	""
"[english]TF_Class_Name_Undefined"	""
"TF_Class_Name_Scout"	"Trinh sát"
"[english]TF_Class_Name_Scout"	"Scout"
"TF_Class_Name_Sniper"	"Sniper"
"[english]TF_Class_Name_Sniper"	"Sniper"
"TF_Class_Name_Soldier"	"Soldier"
"[english]TF_Class_Name_Soldier"	"Soldier"
"TF_Class_Name_Demoman"	"Demoman"
"[english]TF_Class_Name_Demoman"	"Demoman"
"TF_Class_Name_Medic"	"Bác sĩ"
"[english]TF_Class_Name_Medic"	"Medic"
"TF_Class_Name_HWGuy"	"Heavy"
"[english]TF_Class_Name_HWGuy"	"Heavy"
"TF_Class_Name_Pyro"	"Pyro"
"[english]TF_Class_Name_Pyro"	"Pyro"
"TF_Class_Name_Spy"	"Gián điệp"
"[english]TF_Class_Name_Spy"	"Spy"
"TF_Class_Name_Engineer"	"Kỹ sư"
"[english]TF_Class_Name_Engineer"	"Engineer"
"TF_ScoreBoard_Blue"	"BLU"
"[english]TF_ScoreBoard_Blue"	"BLU"
"TF_ScoreBoard_Red"	"RED"
"[english]TF_ScoreBoard_Red"	"RED"
"TF_ScoreBoard_Player"	"%s1 người chơi"
"[english]TF_ScoreBoard_Player"	"%s1 player"
"TF_ScoreBoard_Players"	"%s1 người chơi"
"[english]TF_ScoreBoard_Players"	"%s1 players"
"ScoreBoard_Spectator"	"%s1 người xem: %s2"
"[english]ScoreBoard_Spectator"	"%s1 spectator: %s2"
"ScoreBoard_Spectators"	"%s1 người xem: %s2"
"[english]ScoreBoard_Spectators"	"%s1 spectators: %s2"
"TF_ScoreBoard_DEAD"	"CHẾT"
"[english]TF_ScoreBoard_DEAD"	"DEAD"
"TF_Scoreboard_Name"	"Tên"
"[english]TF_Scoreboard_Name"	"Name"
"TF_Scoreboard_Score"	"Điểm"
"[english]TF_Scoreboard_Score"	"Score"
"TF_Scoreboard_Ping"	"Độ trễ"
"[english]TF_Scoreboard_Ping"	"Ping"
"TF_Scoreboard_Bot"	"Máy"
"[english]TF_Scoreboard_Bot"	"BOT"
"TF_ScoreBoard_Point"	"%s1 điểm"
"[english]TF_ScoreBoard_Point"	"%s1 point"
"TF_ScoreBoard_Points"	"%s1 điểm"
"[english]TF_ScoreBoard_Points"	"%s1 points"
"TF_ScoreBoard_KillsLabel"	"Giết:"
"[english]TF_ScoreBoard_KillsLabel"	"Kills:"
"TF_ScoreBoard_DeathsLabel"	"Chết:"
"[english]TF_ScoreBoard_DeathsLabel"	"Deaths:"
"TF_ScoreBoard_AssistsLabel"	"Hỗ trợ:"
"[english]TF_ScoreBoard_AssistsLabel"	"Assists:"
"TF_ScoreBoard_DestructionLabel"	"Phá hủy:"
"[english]TF_ScoreBoard_DestructionLabel"	"Destruction:"
"TF_ScoreBoard_CapturesLabel"	"Chiếm:"
"[english]TF_ScoreBoard_CapturesLabel"	"Captures:"
"TF_ScoreBoard_DefensesLabel"	"Phòng thủ:"
"[english]TF_ScoreBoard_DefensesLabel"	"Defenses:"
"TF_ScoreBoard_DominationLabel"	"Đàn áp:"
"[english]TF_ScoreBoard_DominationLabel"	"Domination:"
"TF_ScoreBoard_RevengeLabel"	"Trả thù:"
"[english]TF_ScoreBoard_RevengeLabel"	"Revenge:"
"TF_ScoreBoard_HealingLabel"	"Hồi máu:"
"[english]TF_ScoreBoard_HealingLabel"	"Healing:"
"TF_ScoreBoard_InvulnLabel"	"Bất khả xâm phạm:"
"[english]TF_ScoreBoard_InvulnLabel"	"Invulns:"
"TF_ScoreBoard_TeleportsLabel"	"Dịch chuyển:"
"[english]TF_ScoreBoard_TeleportsLabel"	"Teleports:"
"TF_ScoreBoard_HeadshotsLabel"	"Tỉa số đầu:"
"[english]TF_ScoreBoard_HeadshotsLabel"	"Headshots:"
"TF_ScoreBoard_BackstabsLabel"	"Đâm sau lưng:"
"[english]TF_ScoreBoard_BackstabsLabel"	"Backstabs:"
"TF_ScoreBoard_BonusLabel"	"Thưởng:"
"[english]TF_ScoreBoard_BonusLabel"	"Bonus:"
"TF_ScoreBoard_DamageLabel"	"Sát thương:"
"[english]TF_ScoreBoard_DamageLabel"	"Damage:"
"TF_ScoreBoard_SentryKillsLabel"	"Số lần phá súng máy:"
"[english]TF_ScoreBoard_SentryKillsLabel"	"Sentry Kills:"
"Scoreboard_Server"	"Máy chủ: %s1"
"[english]Scoreboard_Server"	"Server: %s1"
"Scoreboard_TimeLeft"	"Thời gian còn lại của bản đồ: %s1:%s2:%s3"
"[english]Scoreboard_TimeLeft"	"Server map time left: %s1:%s2:%s3"
"Scoreboard_TimeLeftNoHours"	"Thời gian còn lại bản đồ: %s1:%s2"
"[english]Scoreboard_TimeLeftNoHours"	"Server map time left: %s1:%s2"
"Scoreboard_NoTimeLimit"	"Thời gian còn lại bản đồ: Không giới hạn"
"[english]Scoreboard_NoTimeLimit"	"Server map time left: No time limit"
"Scoreboard_ChangeOnRoundEnd"	"(Thay đổi bản đồ khi hết hiệp ... ) Thời gian còn lại bản đồ: 00:00"
"[english]Scoreboard_ChangeOnRoundEnd"	"(Map change on round end...) Server map time left: 00:00"
"TF_SteamRequired"	"Yêu cầu Steam"
"[english]TF_SteamRequired"	"Steam Required"
"TF_SteamRequiredResetStats"	"Yêu cầu kết nối với Steam để thiết lập lại thống kê thành tích của bạn."
"[english]TF_SteamRequiredResetStats"	"A connection to Steam is required in order to reset your statistics."
"TF_Nemesis"	"KẺ THÙ"
"[english]TF_Nemesis"	"NEMESIS"
"TF_Dominated"	"ĐÈ BẸP"
"[english]TF_Dominated"	"DOMINATED"
"TF_NewNemesis"	"Kẻ thù mới !"
"[english]TF_NewNemesis"	"New Nemesis!"
"TF_GotRevenge"	"Trả thù!"
"[english]TF_GotRevenge"	"Revenge!"
"TF_FreezeNemesis"	"Kẻ thù"
"[english]TF_FreezeNemesis"	"Nemesis"
"TF_Taunt"	"Chế nhạo"
"[english]TF_Taunt"	"Taunts"
"TF_FeignArmed"	"-VŨ TRANG-"
"[english]TF_FeignArmed"	"-ARMED-"
"ClassTips_1_1"	"Bạn nắm bắt cứ điểm nhanh hơn so với các nhân vật khác!"
"[english]ClassTips_1_1"	"You capture points faster than other classes!"
"ClassTips_2_1"	"Súng bắn tỉa của bạn sẽ nạp năng lượng để gây thêm sát thương khi bạn đang nhòm!"
"[english]ClassTips_2_1"	"Your sniper rifle will power up to do more damage while you are zoomed in!"
"ClassTips_3_1"	"Phóng tên lửa tại chân của đối phương!"
"[english]ClassTips_3_1"	"Shoot your rocket launcher at enemy's feet!"
"ClassTips_4_1"	"Kích hoạt từ xa bom dính khi kẻ địch đến gần mấy quả bom!"
"[english]ClassTips_4_1"	"Remote detonate your stickybombs when enemies are near them!"
"ClassTips_6_1"	"Quay khẩu minigun nhưng không bắn để chuẩn bị khi kẻ địch đến gần!"
"[english]ClassTips_6_1"	"Spin your minigun without firing to be ready for approaching enemies!"
"ClassTips_7_1"	"Phục kích kẻ thù ở các góc!"
"[english]ClassTips_7_1"	"Ambush enemies at corners!"
"ClassTips_8_1"	"Cải trang thành kẻ thù và xâm nhập vào căn cứ đối phương!"
"[english]ClassTips_8_1"	"Disguise yourself as a enemy and infiltrate the enemy base!"
"ClassTips_9_1"	"Nhặt kim loại từ vũ khí rơi trên đường để xây dựng!"
"[english]ClassTips_9_1"	"Collect metal from fallen weapons to build with!"
"ClassTips_12_1"	"Để trò chơi ngẫu nhiên chọn một nhân vật cho bạn."
"[english]ClassTips_12_1"	"Let the game randomly choose a class for you."
"TF_Welcome"	"Chào mừng"
"[english]TF_Welcome"	"Welcome"
"TF_Welcome_birthday"	"Chào mừng và Chúc mừng sinh nhật TF!"
"[english]TF_Welcome_birthday"	"Welcome and Happy Birthday TF!"
"TF_Welcome_halloween"	"Chào mừng và chúc Halloween vui vẻ!"
"[english]TF_Welcome_halloween"	"Welcome and Happy Halloween!"
"TF_Cancel"	"HỦY (&0)"
"[english]TF_Cancel"	"CANCEL (&0)"
"TF_Back"	"&QUAY LẠI"
"[english]TF_Back"	"&BACK"
"TF_WatchIntro"	"&XEM PHIM"
"[english]TF_WatchIntro"	"&WATCH MOVIE"
"Button_SkipIntro"	"&BỎ QUA PHIM"
"[english]Button_SkipIntro"	"&SKIP MOVIE"
"TF_Continue"	"&TIẾP TỤC"
"[english]TF_Continue"	"&CONTINUE"
"TF_SelectATeam"	"CHỌN  MỘT ĐỘI"
"[english]TF_SelectATeam"	"SELECT A TEAM"
"TF_SelectAClass"	"CHỌN NHÂN VẬT"
"[english]TF_SelectAClass"	"SELECT A CLASS"
"TF_AutoTeamSelect"	"TỰ ĐỘNG CHỌN"
"[english]TF_AutoTeamSelect"	"AUTO SELECT"
"TF_Spectate"	"QUAN SÁT"
"[english]TF_Spectate"	"SPECTATE"
"TF_Play"	"CHƠI!"
"[english]TF_Play"	"PLAY!"
"TF_Close"	"&ĐÓNG"
"[english]TF_Close"	"&CLOSE"
"TF_NextTip"	"MẸO &TIẾP THEO"
"[english]TF_NextTip"	"NEXT &TIP"
"TF_NextTip_360"	"Mẹo tiếp theo"
"[english]TF_NextTip_360"	"Next Tip"
"TF_Confirm"	"Xác nhận"
"[english]TF_Confirm"	"Confirm"
"TF_ConfirmResetStats"	"Bạn có chắc chắn muốn cài đặt lại các chỉ số nhân vật của bạn?\nMột khi đã chọn cài đặt lại thì chỉ số cũ sẽ không thể hồi phục lại!"
"[english]TF_ConfirmResetStats"	"Are you sure you want to reset your player stats?\nOnce reset your old stats cannot be recovered!"
"TF_TeamsSwitched"	"Đội đã được chuyển."
"[english]TF_TeamsSwitched"	"Teams have been switched."
"TF_ClassMenu_Reset"	"TÁI LẬP"
"[english]TF_ClassMenu_Reset"	"RESET"
"TF_WatchIntro_360"	"Xem phim"
"[english]TF_WatchIntro_360"	"Watch Movie"
"Button_SkipIntro_360"	"Bỏ qua phim"
"[english]Button_SkipIntro_360"	"Skip Movie"
"TF_Continue_360"	"Tiếp tục"
"[english]TF_Continue_360"	"Continue"
"TF_Offense"	"TẤN CÔNG"
"[english]TF_Offense"	"OFFENSE"
"TF_Defense"	"PHÒNG THỦ"
"[english]TF_Defense"	"DEFENSE"
"TF_Support"	"HỖ TRỢ"
"[english]TF_Support"	"SUPPORT"
"TF_Next"	"Tiếp"
"[english]TF_Next"	"Next"
"TF_Prev"	"Trước"
"[english]TF_Prev"	"Previous"
"TF_NextPrev"	"Tiếp / Trước"
"[english]TF_NextPrev"	"Next / Previous"
"TF_timeleft"	"Thời gian còn lại: %s1:%s2"
"[english]TF_timeleft"	"Time left:  %s1:%s2"
"TF_timeleft_nolimit"	"* Không giới hạn thời gian *"
"[english]TF_timeleft_nolimit"	"* No Time Limit *"
"TF_nextmap"	"Bản đồ tiếp theo : %s1"
"[english]TF_nextmap"	"Next map : %s1"
"TF_PlayingTo"	"Số hiệp chơi: %rounds%"
"[english]TF_PlayingTo"	"Playing to: %rounds%"
"TF_Cloak"	"ẨN ĐI"
"[english]TF_Cloak"	"CLOAK"
"TF_Metal"	"KIM LOẠI"
"[english]TF_Metal"	"METAL"
"TF_Phase"	"NÉ"
"[english]TF_Phase"	"DODGE"
"TF_Ball"	"BÓNG"
"[english]TF_Ball"	"BALL"
"TF_Jar"	"BÌNH"
"[english]TF_Jar"	"JAR"
"TF_Rage"	"THỊNH NỘ"
"[english]TF_Rage"	"RAGE"
"TF_Berzerk"	"ĐẦU"
"[english]TF_Berzerk"	"HEADS"
"TF_Charge"	"NĂNG LƯỢNG"
"[english]TF_Charge"	"CHARGE"
"TF_OUT_OF_AMMO"	"HẾT ĐẠN"
"[english]TF_OUT_OF_AMMO"	"OUT OF AMMO"
"Game_connected"	"%s1 đã kết nối"
"[english]Game_connected"	"%s1 connected"
"game_spawn_as"	"*Bạn sẽ chơi trong vai %s1"
"[english]game_spawn_as"	"*You will spawn as %s1"
"game_respawn_as"	"*Bạn sẽ xuất hiện lại trong vai %s1"
"[english]game_respawn_as"	"*You will respawn as %s1"
"game_spawn_asrandom"	"*Bạn sẽ làm nhân vật bất kì"
"[english]game_spawn_asrandom"	"*You will spawn as random class"
"game_respawn_asrandom"	"*Bạn sẽ được hồi sinh làm 1 nhân vật bất kì"
"[english]game_respawn_asrandom"	"*You will respawn as a random class"
"round_restart_in_sec"	"Vòng này sẽ khởi động lại trong vòng %s1 giây"
"[english]round_restart_in_sec"	"The round will restart in %s1 second"
"round_restart_in_secs"	"Vòng này sẽ khởi động lại trong vòng %s1 giây"
"[english]round_restart_in_secs"	"The round will restart in %s1 seconds"
"game_restart_in_sec"	"Trò chơi sẽ được thiết lập lại trong %s1 giây"
"[english]game_restart_in_sec"	"The game will restart in %s1 second"
"game_restart_in_secs"	"Trò chơi này sẽ được khởi động lại trong vòng %s1 giây"
"[english]game_restart_in_secs"	"The game will restart in %s1 seconds"
"game_switch_in_sec"	"Đổi đội!\nTrận đấu sẽ được thiết lập lại trong %s1 giây"
"[english]game_switch_in_sec"	"Switching teams!\nThe game will restart in %s1 second"
"game_switch_in_secs"	"Đổi đội!\nTrận đấu sẽ được thiết lập lại trong %s1 giây"
"[english]game_switch_in_secs"	"Switching teams!\nThe game will restart in %s1 seconds"
"game_scramble_in_sec"	"Xáo trộn đội hình!\nTrận đấu này sẽ khởi động lại trong %s1 giây"
"[english]game_scramble_in_sec"	"Scrambling the teams!\nThe game will restart in %s1 second"
"game_scramble_in_secs"	"Xáo trộn đội hình!\nTrận đấu sẽ khởi động lại trong %s1 giây"
"[english]game_scramble_in_secs"	"Scrambling the teams!\nThe game will restart in %s1 seconds"
"game_respawntime_now"	"Chuẩn bị để hồi sinh"
"[english]game_respawntime_now"	"Prepare to respawn"
"game_respawntime_in_sec"	"Hồi sinh trong: 1 giây"
"[english]game_respawntime_in_sec"	"Respawn in: 1 second"
"game_respawntime_in_secs"	"Hồi sinh trong: %s1 giây"
"[english]game_respawntime_in_secs"	"Respawn in: %s1 seconds"
"game_respawntime_next_round"	"Xuất hiện lại trong: Chờ hiệp kế tiếp"
"[english]game_respawntime_next_round"	"Respawn in: Wait for next round"
"game_auto_team_balance_in"	"Các đội sẽ được tự động cân bằng trong %s1 giây."
"[english]game_auto_team_balance_in"	"Teams will be auto-balanced in %s1 seconds."
"game_player_was_team_balanced"	"%s1 đã chuyển sang nhóm khác cho cân bằng trò chơi"
"[english]game_player_was_team_balanced"	"%s1 was moved to the other team for game balance"
"game_idle_kick"	"%s1 đã không di chuyển quá lâu và đã bị đuổi"
"[english]game_idle_kick"	"%s1 has been idle for too long and has been kicked"
"TF_MOTD_Title"	"THÔNG ĐIỆP CỦA NGÀY"
"[english]TF_MOTD_Title"	"MESSAGE OF THE DAY"
"TF_playerid_sameteam"	"%s1%s2"
"[english]TF_playerid_sameteam"	"%s1%s2"
"TF_playerid_noteam"	"%s1"
"[english]TF_playerid_noteam"	"%s1"
"TF_playerid_object"	"%s1 được xây bởi %s2"
"[english]TF_playerid_object"	"%s1 built by %s2"
"TF_playerid_object_level"	"( Cấp %s1 )"
"[english]TF_playerid_object_level"	"( Level %s1 )"
"TF_playerid_object_upgrading"	"Quá trình nâng cấp: %s1"
"[english]TF_playerid_object_upgrading"	"Upgrade Progress: %s1"
"TF_playerid_object_upgrading_level"	"( Cấp %s1 ) Tiến độ nâng cấp: %s2"
"[english]TF_playerid_object_upgrading_level"	"( Level %s1 ) Upgrade Progress: %s2"
"TF_playerid_object_diffteam"	"%s1 của kẻ thù được xây dựng bởi %s2"
"[english]TF_playerid_object_diffteam"	"Enemy %s1 built by %s2"
"TF_playerid_object_recharging"	"Nạp: %s1%"
"[english]TF_playerid_object_recharging"	"Recharging: %s1%"
"TF_playerid_healer"	"Người hồi máu: "
"[english]TF_playerid_healer"	"Healer: "
"TF_playerid_healtarget"	"Đang hồi máu: "
"[english]TF_playerid_healtarget"	"Healing: "
"TF_playerid_friendlyspy_disguise"	"Đã cải trang thành %s1 %s2"
"[english]TF_playerid_friendlyspy_disguise"	"Disguised as %s1 %s2"
"TF_playerid_mediccharge"	"ÜberCharge: %s1%"
"[english]TF_playerid_mediccharge"	"ÜberCharge: %s1%"
"TF_playerid_noheal"	"%s1 ngăn hồi máu!"
"[english]TF_playerid_noheal"	"%s1 blocks healing!"
"TF_friendly"	"đồng đội"
"[english]TF_friendly"	"friendly"
"TF_enemy"	"kẻ thù"
"[english]TF_enemy"	"enemy"
"TF_Title"	"TEAM FORTRESS"
"[english]TF_Title"	"TEAM FORTRESS"
"TF_ClassSpecific_Keys"	"KỸ NĂNG RIÊNG BIỆT CỦA NHÂN VẬT"
"[english]TF_ClassSpecific_Keys"	"CLASS SPECIFIC SKILL"
"TF_ClassSkill_Heavy"	"HEAVY: Quay nòng súng"
"[english]TF_ClassSkill_Heavy"	"HEAVY: Spin Minigun Barrel"
"TF_ClassSkill_Sniper"	"SNIPER: Phóng to ống ngắm súng tỉa"
"[english]TF_ClassSkill_Sniper"	"SNIPER: Zoom Sniper Rifle"
"TF_ClassSkill_Demoman"	"DEMOMAN: Kích hoạt bom dính"
"[english]TF_ClassSkill_Demoman"	"DEMOMAN: Detonate Stickybombs"
"TF_Call_For_Medic"	"Gọi Cứu Thương"
"[english]TF_Call_For_Medic"	"Call for a Medic"
"TF_DropFlag"	"Đánh rơi cặp hồ sơ"
"[english]TF_DropFlag"	"Drop the briefcase"
"TF_Switch_Classes_Immediately"	"Đổi nhân vật ngay lập tức"
"[english]TF_Switch_Classes_Immediately"	"Switch classes immediately"
"TF_MapInfo"	"Hiện Thông tin Bản đồ"
"[english]TF_MapInfo"	"Show Map Information"
"TF_freezecam_snapshot"	"[%s1] Lưu lại khoảnh khắc này!"
"[english]TF_freezecam_snapshot"	"[%s1] Save this moment!"
"TF_Chat_All"	"%s1 : %s2"
"[english]TF_Chat_All"	"%s1 :  %s2"
"TF_Chat_AllDead"	"*CHẾT* %s1 : %s2"
"[english]TF_Chat_AllDead"	"*DEAD* %s1 :  %s2"
"TF_Name_Change"	"* %s1 đã đổi tên thành %s2"
"[english]TF_Name_Change"	"* %s1 changed name to %s2"
"Econ_holiday_restriction_halloween"	"Giới hạn cho: Halloween"
"[english]Econ_holiday_restriction_halloween"	"Holiday Restriction: Halloween"
"TF_Weapon_Bat"	"Gậy"
"[english]TF_Weapon_Bat"	"Bat"
"TF_Weapon_Bottle"	"Chai"
"[english]TF_Weapon_Bottle"	"Bottle"
"TF_Weapon_FireAxe"	"Rìu cứu hoả"
"[english]TF_Weapon_FireAxe"	"Fire Axe"
"TF_Weapon_Club"	"Mã tấu"
"[english]TF_Weapon_Club"	"Kukri"
"TF_Weapon_Crowbar"	"Xà beng"
"[english]TF_Weapon_Crowbar"	"Crowbar"
"TF_Weapon_FlameThrower"	"Súng phun lửa"
"[english]TF_Weapon_FlameThrower"	"Flame Thrower"
"TF_Weapon_GrenadeLauncher"	"Súng phóng lựu"
"[english]TF_Weapon_GrenadeLauncher"	"Grenade Launcher"
"TF_Weapon_Knife"	"Dao"
"[english]TF_Weapon_Knife"	"Knife"
"TF_Weapon_Medikit"	"Hộp cứu thương"
"[english]TF_Weapon_Medikit"	"Medikit"
"TF_Weapon_Pistol"	"Súng ngắn"
"[english]TF_Weapon_Pistol"	"Pistol"
"TF_Weapon_Fists"	"Nắm đấm"
"[english]TF_Weapon_Fists"	"Fists"
"TF_Weapon_Shovel"	"Xẻng"
"[english]TF_Weapon_Shovel"	"Shovel"
"TF_Weapon_SMG"	"Súng tiểu liên"
"[english]TF_Weapon_SMG"	"SMG"
"TF_Weapon_SniperRifle"	"Súng tỉa"
"[english]TF_Weapon_SniperRifle"	"Sniper Rifle"
"TF_Weapon_Wrench"	"Mỏ lết"
"[english]TF_Weapon_Wrench"	"Wrench"
"TF_Weapon_Watch"	"Đồng hồ tàng hình"
"[english]TF_Weapon_Watch"	"Invis Watch"
"TF_Weapon_LunchBox"	"Hộp ăn trưa"
"[english]TF_Weapon_LunchBox"	"Lunch Box"
"TF_Wearable_Shield"	"Khiên"
"[english]TF_Wearable_Shield"	"Shield"
"TF_Weapon_CompoundBow"	"Cung"
"[english]TF_Weapon_CompoundBow"	"Bow"
"TF_Weapon_Battle_Banner"	"Cờ Chiến"
"[english]TF_Weapon_Battle_Banner"	"Battle Banner"
"TF_Weapon_Sword"	"Kiếm"
"[english]TF_Weapon_Sword"	"Sword"
"TF_Weapon_Pickaxe"	"Cuốc chim"
"[english]TF_Weapon_Pickaxe"	"Pickaxe"
"TF_Wearable_Boots"	"Giày"
"[english]TF_Wearable_Boots"	"Boots"
"TF_Wearable_Medal"	"Huy chương"
"[english]TF_Wearable_Medal"	"Medal"
"TF_Sniper_Hat_1"	"Đai Thành Tích"
"[english]TF_Sniper_Hat_1"	"Trophy Belt"
"TF_Soldier_Pot_Hat"	"Nồi không gỉ"
"[english]TF_Soldier_Pot_Hat"	"Stainless Pot"
"TF_Soldier_Viking_Hat"	"Mũ sắt bạo chúa"
"[english]TF_Soldier_Viking_Hat"	"Tyrant's Helm"
"TF_Spy_Camera_Beard"	"Râu gắn máy quay"
"[english]TF_Spy_Camera_Beard"	"Camera Beard"
"TF_Pyro_Fireman_Helmet"	"Mũ lính cứu hỏa"
"[english]TF_Pyro_Fireman_Helmet"	"Brigade Helm"
"TF_L4DHat"	"Nón của Bill"
"[english]TF_L4DHat"	"Bill's Hat"
"DeathMsg_AssistedSuicide"	"kết liễu"
"[english]DeathMsg_AssistedSuicide"	"finished off"
"Msg_Captured"	"đã bị chiếm giữ"
"[english]Msg_Captured"	"captured"
"Msg_Defended"	"bảo vệ thành công"
"[english]Msg_Defended"	"defended"
"TF_OK"	"OK"
"[english]TF_OK"	"OK"
"TF_Spy_Disguise_Team_Blue"	"BLU"
"[english]TF_Spy_Disguise_Team_Blue"	"BLU"
"TF_Spy_Disguise_Team_Red"	"RED"
"[english]TF_Spy_Disguise_Team_Red"	"RED"
"TF_Object_Sentry"	"Súng Sentry"
"[english]TF_Object_Sentry"	"Sentry Gun"
"TF_Object_Sentry_360"	"Sentry"
"[english]TF_Object_Sentry_360"	"Sentry"
"TF_Object_Tele_Exit_360"	"Thoát"
"[english]TF_Object_Tele_Exit_360"	"Exit"
"TF_Obj_Teleporter_State_Ready"	"Sẵn sàng"
"[english]TF_Obj_Teleporter_State_Ready"	"Ready"
"CP5_red_setup_goal"	"Chiếm cả 5 cứ điểm để chiến thắng trò chơi !"
"[english]CP5_red_setup_goal"	"Capture all five of the Control Points to win the game!"
"CP_setup_30sec"	"Trận đấu sẽ bắt đầu trong vòng 30 giây nữa!"
"[english]CP_setup_30sec"	"Game begins in 30 seconds!"
"CP_setup_10sec"	"Trận đấu sẽ bắt đầu trong vòng 10 giây nữa!"
"[english]CP_setup_10sec"	"Game begins in 10 seconds!"
"CP_cap_red_cp1"	"Căn cứ ĐỎ"
"[english]CP_cap_red_cp1"	"the RED Base"
"CP_cap_blue_cp1"	"Căn cứ XANH"
"[english]CP_cap_blue_cp1"	"the BLU Base"
"Dustbowl_90_secs"	"90 giây cho đến khi cổng mở."
"[english]Dustbowl_90_secs"	"90 seconds till gates open."
"Dustbowl_60_secs"	"60 giây cho đến khi cổng mở."
"[english]Dustbowl_60_secs"	"60 seconds till gates open."
"Dustbowl_30_secs"	"30 giây cho đến khi cổng mở."
"[english]Dustbowl_30_secs"	"30 seconds till gates open."
"Dustbowl_10_secs"	"10 giây cho đến khi cổng mở."
"[english]Dustbowl_10_secs"	"10 seconds till gates open."
"Dustbowl_gates_open"	"Cổng đã được mở !!"
"[english]Dustbowl_gates_open"	"Gates are open !!"
"Hydro_cap_warehouse"	"Nhà kho"
"[english]Hydro_cap_warehouse"	"the Warehouse"
"Well_setup_30sec"	"Trò chơi sẽ bắt đầu trong 30 giây!"
"[english]Well_setup_30sec"	"Game begins in 30 seconds!"
"Well_setup_10sec"	"Trò chơi sẽ bắt đầu trong 10 giây!"
"[english]Well_setup_10sec"	"Game begins in 10 seconds!"
"Well_cap_red_two"	"Nhà kho đội Đỏ"
"[english]Well_cap_red_two"	"the RED Warehouse"
"Well_cap_red_rocket"	"Căn cứ đội đỏ"
"[english]Well_cap_red_rocket"	"the RED Base"
"Well_cap_blue_two"	"Nhà kho đội xanh"
"[english]Well_cap_blue_two"	"the BLU Warehouse"
"Well_cap_blue_rocket"	"Căn cứ đội xanh"
"[english]Well_cap_blue_rocket"	"the BLU Base"
"koth_viaduct_cap"	"Cứ điểm"
"[english]koth_viaduct_cap"	"the Control Point"
"Winpanel_Team1"	"ĐỘI"
"[english]Winpanel_Team1"	"TEAM"
"Winpanel_Team2"	"Đội"
"[english]Winpanel_Team2"	"Team"
"Winpanel_BlueWins"	"ĐỘI XANH THẮNG !"
"[english]Winpanel_BlueWins"	"BLU TEAM WINS!"
"Winpanel_TeamWins"	"%s1 %s2 THẮNG!"
"[english]Winpanel_TeamWins"	"%s1 %s2 WINS!"
"Winpanel_TeamLost"	"%s1 %s2 THUA!"
"[english]Winpanel_TeamLost"	"%s1 %s2 LOST!"
"Winpanel_TopPlayers"	"Người chơi dẫn đầu:"
"[english]Winpanel_TopPlayers"	"Top Players:"
"Winreason_Stalemate"	"Tất cả là lũ thua cuộc"
"[english]Winreason_Stalemate"	"You're all losers"
"Tournament_TeamReady"	"Sẵn sàng"
"[english]Tournament_TeamReady"	"Ready"
"Tournament_TeamNotReady"	"Chưa sẵn sàng"
"[english]Tournament_TeamNotReady"	"Not Ready"
"Tournament_WinConditionsMinute"	"phút"
"[english]Tournament_WinConditionsMinute"	"minute"
"Tournament_WinConditionsMinutes"	"phút"
"[english]Tournament_WinConditionsMinutes"	"minutes"
"Tournament_WinConditionsWins"	"Thắng"
"[english]Tournament_WinConditionsWins"	"wins"
"Tournament_WinConditionsNone"	"Trống"
"[english]Tournament_WinConditionsNone"	"None"
"Tournament_WinConditionsSecond"	"giây"
"[english]Tournament_WinConditionsSecond"	"second"
"Tournament_WinConditionsSeconds"	"giây"
"[english]Tournament_WinConditionsSeconds"	"seconds"
"Tournament_TeamSetupNotReady"	"Đội chưa sẵn sàng"
"[english]Tournament_TeamSetupNotReady"	"Team Not Ready"
"Tournament_TeamSetupReady"	"Đội đã sẵn sàng"
"[english]Tournament_TeamSetupReady"	"Team Ready"
"Tournament_Instructions"	"F4 = đổi tên đội/trạng thái"
"[english]Tournament_Instructions"	"F4 = change team name/status"
"Tournament_TeamNamePanel"	"Tên đội"
"[english]Tournament_TeamNamePanel"	"Team Name"
"Winpanel_TournamentTeamWins"	"%s1 THẮNG!"
"[english]Winpanel_TournamentTeamWins"	"%s1 WINS!"
"Winpanel_TournamentTeamLost"	"%s1 THUA!"
"[english]Winpanel_TournamentTeamLost"	"%s1 LOST!"
"Tournament_StopWatch_Point"	"điểm"
"[english]Tournament_StopWatch_Point"	"point"
"Tournament_StopWatch_Points"	"điểm"
"[english]Tournament_StopWatch_Points"	"points"
"TF_Gates_90_secs"	"90 giây trước khi cổng mở."
"[english]TF_Gates_90_secs"	"90 seconds till gates open."
"TF_Gates_60_secs"	"60 giây trước khi cổng mở."
"[english]TF_Gates_60_secs"	"60 seconds till gates open."
"TF_Gates_30_secs"	"30 giây trước khi cổng mở."
"[english]TF_Gates_30_secs"	"30 seconds till gates open."
"TF_Gates_10_secs"	"10 giây trước khi cổng mở."
"[english]TF_Gates_10_secs"	"10 seconds till gates open."
"TF_Gates_open"	"Cổng mở !!"
"[english]TF_Gates_open"	"Gates are open !!"
"TF_Time_FiveMinutesLeft"	"Thời gian còn lại:\nNăm phút"
"[english]TF_Time_FiveMinutesLeft"	"Time remaining:\nFive minutes"
"TF_Time_FourMinutesLeft"	"Thời gian còn lại:\nBốn phút"
"[english]TF_Time_FourMinutesLeft"	"Time remaining:\nFour minutes"
"TF_Time_ThreeMinutesLeft"	"Thời gian còn lại:\nBa phút"
"[english]TF_Time_ThreeMinutesLeft"	"Time remaining:\nThree minutes"
"TF_Time_TwoMinutesLeft"	"Thời gian còn lại:\nHai phút"
"[english]TF_Time_TwoMinutesLeft"	"Time remaining:\nTwo minutes"
"TF_Time_SixtySecondsLeft"	"Thời gian còn lại:\nSáu mươi giây"
"[english]TF_Time_SixtySecondsLeft"	"Time remaining:\nSixty seconds"
"TF_Time_ThirtySecondsLeft"	"Thời gian còn lại:\nBa mươi giây"
"[english]TF_Time_ThirtySecondsLeft"	"Time remaining:\nThirty seconds"
"TF_CTF_PlayerTeamPickup"	"Đội của bạn ĐÃ NHẶT TẬP TÀI LIỆU CỦA ĐỐI PHƯƠNG !"
"[english]TF_CTF_PlayerTeamPickup"	"Your team PICKED UP the ENEMY INTELLIGENCE!"
"TF_CTF_OtherTeamPickup"	"CẶP TÀI LIỆU CỦA ĐỘI BẠN đã BỊ LẤY !"
"[english]TF_CTF_OtherTeamPickup"	"Your INTELLIGENCE has been PICKED UP!"
"TF_CTF_PlayerDrop"	"Bạn đánh rơi cặp tài liệu của kẻ thù !"
"[english]TF_CTF_PlayerDrop"	"You dropped the ENEMY INTELLIGENCE!"
"Team_Waiting_for_teammate"	"Chờ\nđồng đội"
"[english]Team_Waiting_for_teammate"	"Waiting for\nteammate"
"Team_Progress_Blocked"	"Quá trình\nbị chặn\nbởi kẻ thù."
"[english]Team_Progress_Blocked"	"Progress\nblocked\nby enemy"
"FreezePanel_NoKiller"	"Bạn vừa bị giết"
"[english]FreezePanel_NoKiller"	"You were killed"
"FreezePanel_Callout"	"Một mẩu của bạn!"
"[english]FreezePanel_Callout"	"A bit of you!"
"FreezePanel_Callout2"	"Mẩu khác!"
"[english]FreezePanel_Callout2"	"Another bit!"
"Callout_Ragdoll"	"Bạn!"
"[english]Callout_Ragdoll"	"You!"
"Callout_Head"	"Đầu bạn!"
"[english]Callout_Head"	"Your head!"
"Callout_Foot"	"Chân bạn!"
"[english]Callout_Foot"	"Your foot!"
"Callout_Hand"	"Tay bạn!"
"[english]Callout_Hand"	"Your hand!"
"game_Setup"	"Cài đặt"
"[english]game_Setup"	"Setup"
"Hint_Engineer_build_sentrygun"	"Xây súng sentry để bảo vệ căn cứ đội bạn.\nÔ thứ tư trong mục lựa chọn vũ khí chứa vật phẩm xây được."
"[english]Hint_Engineer_build_sentrygun"	"Build sentry guns to defend your team's base.\nThe fourth slot in your weapon selection holds buildables."
"StatPanel_Label_Healing"	"Lượng máu đã hồi: "
"[english]StatPanel_Label_Healing"	"Health points healed: "
"StatSummary_Label_TIP"	"MẸO"
"[english]StatSummary_Label_TIP"	"TIP"
"StatSummary_Records"	"HỒ SƠ:"
"[english]StatSummary_Records"	"RECORDS:"
"StatSummary_StatTitle_MostPoints"	"Điểm nhiều nhất"
"[english]StatSummary_StatTitle_MostPoints"	"Most points"
"StatSummary_StatTitle_AvgPoints"	"Điểm trung bình"
"[english]StatSummary_StatTitle_AvgPoints"	"Avg points"
"StatSummary_StatTitle_MostKills"	"Giết nhiều nhất"
"[english]StatSummary_StatTitle_MostKills"	"Most kills"
"StatSummary_StatTitle_AvgKills"	"Giết trung bình"
"[english]StatSummary_StatTitle_AvgKills"	"Avg kills"
"StatSummary_StatTitle_MostCaptures"	"Chiếm đóng nhiều nhất"
"[english]StatSummary_StatTitle_MostCaptures"	"Most captures"
"StatSummary_StatTitle_AvgCaptures"	"Chiến đóng trung bình"
"[english]StatSummary_StatTitle_AvgCaptures"	"Avg captures"
"StatSummary_StatTitle_MostAssists"	"Hỗ trợ nhiều nhất"
"[english]StatSummary_StatTitle_MostAssists"	"Most assists"
"StatSummary_StatTitle_AvgAssists"	"Hỗ trợ trung bình"
"[english]StatSummary_StatTitle_AvgAssists"	"Avg assists"
"StatSummary_StatTitle_MostDamage"	"Sát thương nhiều nhất"
"[english]StatSummary_StatTitle_MostDamage"	"Most damage"
"StatSummary_StatTitle_AvgDamage"	"Sát thương trung bình"
"[english]StatSummary_StatTitle_AvgDamage"	"Avg damage"
"StatSummary_StatTitle_TotalPlaytime"	"Tổng giờ chơi"
"[english]StatSummary_StatTitle_TotalPlaytime"	"Total playtime"
"Tip_1_Count"	"27"
"[english]Tip_1_Count"	"27"
"Tip_1_1"	"Trong vai Scout, nhảy trong không trung để đổi hướng và tránh đạn của đối phương."
"[english]Tip_1_1"	"As a Scout, jump while in mid-air to change direction and avoid enemy fire."
"Tip_1_3"	"Trong vai Scout, bạn hiệu quả nhất khi liên tục di chuyển và sử dụng tốc độ làm lợi thế cho bản thân."
"[english]Tip_1_3"	"As a Scout, you're most effective when you stay moving and use your speed to your advantage."
"Tip_2_Count"	"22"
"[english]Tip_2_Count"	"22"
"Tip_2_1"	"Trong vai Sniper, nhắm càng lâu, sát thương càng cao."
"[english]Tip_2_1"	"As a Sniper, the longer you spend zoomed while scoped, the more damage the shot will do."
"Tip_5_Count"	"31"
"[english]Tip_5_Count"	"31"
"Tip_6_Count"	"22"
"[english]Tip_6_Count"	"22"
"Tip_7_Count"	"32"
"[english]Tip_7_Count"	"32"
"Tip_8_Count"	"40"
"[english]Tip_8_Count"	"40"
"Tip_9_Count"	"31"
"[english]Tip_9_Count"	"31"
"Tip_arena_Count"	"9"
"[english]Tip_arena_Count"	"9"
"Cancel"	"Hủy"
"[english]Cancel"	"Cancel"
"Voice_Menu_Yes"	"Có"
"[english]Voice_Menu_Yes"	"Yes"
"Voice_Menu_No"	"Không"
"[english]Voice_Menu_No"	"No"
"TF_Options_Title"	"Tùy chọn"
"[english]TF_Options_Title"	"Options"
"TF_Quit_Title"	"Thoát"
"[english]TF_Quit_Title"	"Quit"
"TF_Achievement_NumberingFmt"	"%s1 - %s2 của %s3"
"[english]TF_Achievement_NumberingFmt"	"%s1 - %s2 of %s3"
"TF_On"	"Bật"
"[english]TF_On"	"On"
"TF_Off"	"Tắt"
"[english]TF_Off"	"Off"
"TF_MaxTimeNoLimit"	"Không giới hạn"
"[english]TF_MaxTimeNoLimit"	"No Limit"
"TF_GameSizeFmt"	"%s1 người chơi"
"[english]TF_GameSizeFmt"	"%s1 Players"
"TF_Players"	"Người chơi"
"[english]TF_Players"	"Players"
"TF_Icon_Alert"	"!"
"[english]TF_Icon_Alert"	"!"
"TF_Icon_NotReady"	","
"[english]TF_Icon_NotReady"	","
"TF_Icon_Ready"	"."
"[english]TF_Icon_Ready"	"."
"TF_Dlg_Connecting"	"Đang kết nối..."
"[english]TF_Dlg_Connecting"	"Connecting..."
"TF_Spectator_SwitchCamModeKey"	"[%jump%]"
"[english]TF_Spectator_SwitchCamModeKey"	"[%jump%]"
"TF_Spectator_CycleTargetFwdKey"	"[%attack%]"
"[english]TF_Spectator_CycleTargetFwdKey"	"[%attack%]"
"TF_Spectator_CycleTargetRevKey"	"[%attack2%]"
"[english]TF_Spectator_CycleTargetRevKey"	"[%attack2%]"
"TF_KILL_NEMESIS_NAME"	"Tử thù"
"[english]TF_KILL_NEMESIS_NAME"	"Nemesis"
"TF_KILL_NEMESIS_DESC"	"Đòi nợ máu năm lần."
"[english]TF_KILL_NEMESIS_DESC"	"Get five revenge kills."
"TF_GET_CONSECUTIVEKILLS_NODEATHS_NAME"	"Khó giết"
"[english]TF_GET_CONSECUTIVEKILLS_NODEATHS_NAME"	"Hard to Kill"
"TF_GET_CONSECUTIVEKILLS_NODEATHS_DESC"	"Giết năm mạng liên tiếp và không chết."
"[english]TF_GET_CONSECUTIVEKILLS_NODEATHS_DESC"	"Get five kills in a row without dying."
"TF_GET_HEALED_BYENEMY_NAME"	"Bậc thầy cải trang"
"[english]TF_GET_HEALED_BYENEMY_NAME"	"Master of Disguise"
"TF_GET_HEALED_BYENEMY_DESC"	"Lợi dụng bác sĩ của kẻ thù để hồi máu cho bạn."
"[english]TF_GET_HEALED_BYENEMY_DESC"	"Trick an opposing Medic into healing you."
"TF_GET_HEADSHOTS_NAME"	"Chất xám"
"[english]TF_GET_HEADSHOTS_NAME"	"Grey Matter"
"TF_GET_HEADSHOTS_DESC"	"Đạt được 25 phát bắn xuyên đầu khi dùng Xạ thủ."
"[english]TF_GET_HEADSHOTS_DESC"	"Get 25 headshots as a Sniper."
"TF_PLAY_GAME_FRIENDSONLY_NAME"	"Với bạn bè thế này..."
"[english]TF_PLAY_GAME_FRIENDSONLY_NAME"	"With Friends Like these..."
"TF_PLAY_GAME_FRIENDSONLY_DESC"	"Chơi một ván với 7 hoặc nhiều người chơi từ danh sách bạn bè của bạn."
"[english]TF_PLAY_GAME_FRIENDSONLY_DESC"	"Play in a game with 7 or more players from your Friends list."
"TF_WIN_MULTIPLEGAMES_NAME"	"Vương triều"
"[english]TF_WIN_MULTIPLEGAMES_NAME"	"Dynasty"
"TF_GET_MULTIPLEKILLS_NAME"	"Hardcore"
"[english]TF_GET_MULTIPLEKILLS_NAME"	"Hardcore"
"TF_GET_MULTIPLEKILLS_DESC"	"Giết được tổng số 1000 mạng."
"[english]TF_GET_MULTIPLEKILLS_DESC"	"Accumulate 1000 total kills."
"TF_WIN_2FORT_NOENEMYCAPS_NAME"	"Hoả lực khủng khiếp"
"[english]TF_WIN_2FORT_NOENEMYCAPS_NAME"	"Powerhouse Offense"
"TF_WIN_2FORT_NOENEMYCAPS_DESC"	"Thắng 2Fort bằng cách đóng chặt pháo đài."
"[english]TF_WIN_2FORT_NOENEMYCAPS_DESC"	"Win 2Fort with a shutout."
"TF_WIN_WELL_MINIMUMTIME_NAME"	"Tấn công chớp nhoáng"
"[english]TF_WIN_WELL_MINIMUMTIME_NAME"	"Lightning Offense"
"TF_WIN_WELL_MINIMUMTIME_DESC"	"Thắng Well trong 5 phút hoặc ít hơn."
"[english]TF_WIN_WELL_MINIMUMTIME_DESC"	"Win Well in 5 minutes or less."
"TF_WIN_HYDRO_NOENEMYCAPS_DESC"	"Thắng Hydro và không bỏ cứ điểm nào."
"[english]TF_WIN_HYDRO_NOENEMYCAPS_DESC"	"Win Hydro without giving up a capture."
"TF_MEDIC_FREEZECAM_RAGDOLL_NAME"	"Báo cáo khám nghiệm tử thi"
"[english]TF_MEDIC_FREEZECAM_RAGDOLL_NAME"	"Autopsy Report"
"TF_Exit"	"Thoát"
"[english]TF_Exit"	"Exit"
"SelectedItemNumber"	"#%selecteditem%"
"[english]SelectedItemNumber"	"#%selecteditem%"
"Achievements"	"THÀNH TỰU"
"[english]Achievements"	"ACHIEVEMENTS"
"ItemSel_PRIMARY"	"- VŨ KHÍ CHÍNH"
"[english]ItemSel_PRIMARY"	"- PRIMARY WEAPON"
"DeleteConfirmDefault"	"Xóa?"
"[english]DeleteConfirmDefault"	"Delete?"
"LoadoutSlot_Primary"	"Vũ khí chính"
"[english]LoadoutSlot_Primary"	"Primary weapon"
"LoadoutSlot_PrimaryMod"	"Đạn"
"[english]LoadoutSlot_PrimaryMod"	"Ammo"
"of"	"của"
"[english]of"	"of"
"CraftStep4"	"Nhấp vào khi sẵn sàng chế tạo"
"[english]CraftStep4"	"Click when ready to craft"
"RD_RND"	"ngẫu nhiên"
"[english]RD_RND"	"random"
"developer"	"Valve"
"[english]developer"	"Valve"
"TF_CheatDetected_Title"	"CẢNH BÁO"
"[english]TF_CheatDetected_Title"	"WARNING"
"TF_OfflinePractice_Settings"	"Thiết lập"
"[english]TF_OfflinePractice_Settings"	"Settings"
"RI_c"	", "
"[english]RI_c"	", "
"Humiliation_Count"	"x%s1"
"[english]Humiliation_Count"	"x%s1"
"TF_UseFail_NotOnTeam_Title"	"Gia nhập một đội trước!"
"[english]TF_UseFail_NotOnTeam_Title"	"Join A Team First!"
"TF_Duel_Accept"	"%target% đã đồng ý đấu tay đôi với %initiator%!"
"[english]TF_Duel_Accept"	"%target% has agreed to duel with %initiator%!"
"TF_StoreBundle"	"Bộ vật phẩm"
"[english]TF_StoreBundle"	"Item Bundle"
"ShowBaseItemsCheckBox"	"Hiển thị vật phẩm trong kho"
"[english]ShowBaseItemsCheckBox"	"Show Stock Items"
"CraftAskNameWarning"	"(Cái tên này sẽ được hiển thị công khai và vĩnh viễn)"
"[english]CraftAskNameWarning"	"(This name will be publicly visible and permanent)"
"BackpackShowDetails"	"Chi tiết"
"[english]BackpackShowDetails"	"Details"
"TF_T"	"Công cụ"
"[english]TF_T"	"Tool"
"StoreCheckoutExplanation_Title"	"Thanh toán"
"[english]StoreCheckoutExplanation_Title"	"Checkout"
"Store_Headgear"	"Mũ"
"[english]Store_Headgear"	"Hats"
"Store_Weapons"	"Vũ khí"
"[english]Store_Weapons"	"Weapons"
"Store_Tools"	"Công cụ"
"[english]Store_Tools"	"Tools"
"Store_Special_Items"	"Công cụ"
"[english]Store_Special_Items"	"Tools"
"Store_New_Items"	"Mới!"
"[english]Store_New_Items"	"New!"
"Store_FilterLabel"	"Hiện:"
"[english]Store_FilterLabel"	"Show:"
"Store_Cart"	"(%s1)"
"[english]Store_Cart"	"(%s1)"
"Store_Checkout"	"Thanh toán"
"[english]Store_Checkout"	"Checkout"
"Store_Remove"	"Bỏ"
"[english]Store_Remove"	"Remove"
"Store_DetailsItem"	"Chi tiết"
"[english]Store_DetailsItem"	"Details"
"StoreCheckout_Loading"	"Đang thanh toán..."
"[english]StoreCheckout_Loading"	"Checking out..."
"Store_NextWeapon"	"Vũ khí"
"[english]Store_NextWeapon"	"Weapon"
"Notifications_View"	"Xem"
"[english]Notifications_View"	"View"
"Notifications_Accept"	"Chấp nhận"
"[english]Notifications_Accept"	"Accept"
"Notifications_Decline"	"Từ chối"
"[english]Notifications_Decline"	"Decline"
"TF_Trading_JoinText"	"%initiator% muốn trao đổi với bạn!"
"[english]TF_Trading_JoinText"	"%initiator% wants to trade with you!"
"TF_TradeWindow_Step1Desc"	"Kéo vật phẩm từ hòm đồ để thêm chúng vào phiên giao dịch."
"[english]TF_TradeWindow_Step1Desc"	"Drag items to Your Offerings to include them in the trade."
"TF_TradeWindow_WaitingForTrade"	"Đợi cả hai phía tích dấu sẵn sàng."
"[english]TF_TradeWindow_WaitingForTrade"	"Waiting for both parties\nto be ready..."
"TF_TradeWindow_Ellipsis2"	"."
"[english]TF_TradeWindow_Ellipsis2"	"."
"TF_TradeWindow_Ellipsis3"	".."
"[english]TF_TradeWindow_Ellipsis3"	".."
"TF_TradeWindow_Ellipsis4"	"..."
"[english]TF_TradeWindow_Ellipsis4"	"..."
"TF_TradeWindow_WarnPassword"	"Không bao giờ tiết lộ mật khẩu của bạn cho bất kì ai."
"[english]TF_TradeWindow_WarnPassword"	"Never tell your password to anyone."
"ArmoryFilter_Weapons"	"Vũ khí"
"[english]ArmoryFilter_Weapons"	"Weapons"
"ArmoryFilter_Tools"	"Công cụ"
"[english]ArmoryFilter_Tools"	"Tools"
"TF_Serverlist_Ask_Yes"	"Có"
"[english]TF_Serverlist_Ask_Yes"	"Yes"
"TF_Serverlist_Ask_No"	"Không"
"[english]TF_Serverlist_Ask_No"	"No"
"Craft_Untradable_Title"	"Cảnh báo"
"[english]Craft_Untradable_Title"	"Warning"
"TF_TradeWindow_Change_Added"	"%s1 đã thêm: %s2\n"
"[english]TF_TradeWindow_Change_Added"	"%s1 added: %s2\n"
"TF_TradeWindow_Change_Removed"	"%s1 đã bỏ: %s2\n"
"[english]TF_TradeWindow_Change_Removed"	"%s1 removed: %s2\n"
"TF_HalloweenItem_Reserved"	"Một món quà Halloween hắc ám đã bí ẩn xuất hiện ở đâu đó, được đặt ngay cho ngươi. Hãy đi tìm nó!"
"[english]TF_HalloweenItem_Reserved"	"A Haunted Halloween Gift has mysteriously appeared somewhere, placed just for you. Go and find it!"
"TF_Wearable_Glasses"	"Kính"
"[english]TF_Wearable_Glasses"	"Glasses"
"StoreCheckout_ContactSupport_Dialog_Title"	"Cảnh báo"
"[english]StoreCheckout_ContactSupport_Dialog_Title"	"Warning"
"IT_Item_Add"	"Thêm"
"[english]IT_Item_Add"	"Add"
"IT_Item_Edit"	"Sửa"
"[english]IT_Item_Edit"	"Edit"
"IT_Item_Remove"	"X"
"[english]IT_Item_Remove"	"X"
"IT_Bodygroup_Hat"	"Mũ"
"[english]IT_Bodygroup_Hat"	"Hat"
"Replay_HideThisMessage"	"[ %s1 ] để ẩn tin nhắn này"
"[english]Replay_HideThisMessage"	"[ %s1 ] to hide this message"
"Replay_YouTube"	"YouTube™"
"[english]Replay_YouTube"	"YouTube™"
"Replay_YouTubeView"	"Xem trên YouTube"
"[english]Replay_YouTubeView"	"View on YouTube"
"Replay_ClickToEdit"	"BẤM ĐỂ SỬA"
"[english]Replay_ClickToEdit"	"CLICK TO EDIT"
"Replay_SearchText"	"Tìm kiếm"
"[english]Replay_SearchText"	"Search"
"Replay_RenderSetting_Low"	"Thô"
"[english]Replay_RenderSetting_Low"	"Draft"
"Replay_RenderSetting_Medium"	"Tiêu chuẩn"
"[english]Replay_RenderSetting_Medium"	"Standard"
"Replay_RenderSetting_High"	"Cao"
"[english]Replay_RenderSetting_High"	"High"
"Replay_RenderSetting_Max"	"Tối đa"
"[english]Replay_RenderSetting_Max"	"Maximum"
"Replay_Stat_Label_0"	""
"[english]Replay_Stat_Label_0"	""
"Replay_SingleWordDateAndTime"	"%s1 @ %s2"
"[english]Replay_SingleWordDateAndTime"	"%s1 @ %s2"
"Replay_DateAndTime"	"%s1 %s2, %s3 @ %s4"
"[english]Replay_DateAndTime"	"%s1 %s2, %s3 @ %s4"
"Replay_Date"	"%s1 %s2, %s3"
"[english]Replay_Date"	"%s1 %s2, %s3"
"Replay_Today"	"Hôm nay"
"[english]Replay_Today"	"Today"
"Replay_Yesterday"	"Hôm qua"
"[english]Replay_Yesterday"	"Yesterday"
"Replay_Title"	"Tiêu đề"
"[english]Replay_Title"	"Title"
"Replay_Yes"	"Có"
"[english]Replay_Yes"	"Yes"
"Replay_No"	"Không"
"[english]Replay_No"	"No"
"Replay_SpeedMin"	"Chậm hơn"
"[english]Replay_SpeedMin"	"Slower"
"Replay_SpeedMax"	"Nhanh hơn"
"[english]Replay_SpeedMax"	"Faster"
"Replay_FovMin"	"Hẹp hơn"
"[english]Replay_FovMin"	"Narrower"
"Replay_FovMax"	"Rộng hơn"
"[english]Replay_FovMax"	"Wider"
"Replay_Speed"	"Tốc độ:"
"[english]Replay_Speed"	"Speed:"
"Replay_Warning"	"Cảnh báo"
"[english]Replay_Warning"	"Warning"
"Replay_MotionBlur_Low"	"Thấp"
"[english]Replay_MotionBlur_Low"	"Low"
"Replay_MotionBlur_High"	"Cao"
"[english]Replay_MotionBlur_High"	"High"
"Replay_Quality_High"	"Cao"
"[english]Replay_Quality_High"	"High"
"Replay_ExportMovieError_Title"	"Lỗi"
"[english]Replay_ExportMovieError_Title"	"Error"
"Replay_ExportMovieSuccess_Title"	"Thành công"
"[english]Replay_ExportMovieSuccess_Title"	"Success"
"Replay_PerfTip_Highlight_Word8"	"'W'"
"[english]Replay_PerfTip_Highlight_Word8"	"'W'"
"Replay_PerfTip_Highlight_Word9"	"'A'"
"[english]Replay_PerfTip_Highlight_Word9"	"'A'"
"Replay_PerfTip_Highlight_Word10"	"'S'"
"[english]Replay_PerfTip_Highlight_Word10"	"'S'"
"Replay_PerfTip_Highlight_Word11"	"'D'"
"[english]Replay_PerfTip_Highlight_Word11"	"'D'"
"Replay_PerfTip_Highlight_Word12"	"'Z'"
"[english]Replay_PerfTip_Highlight_Word12"	"'Z'"
"Replay_PerfTip_Highlight_Word13"	"'X'"
"[english]Replay_PerfTip_Highlight_Word13"	"'X'"
"Replay_PerfTip_Highlight_NumWords"	"23"
"[english]Replay_PerfTip_Highlight_NumWords"	"23"
"Replay_Res_480p"	"480p (720 x 480 x 23.976)"
"[english]Replay_Res_480p"	"480p (720 x 480 x 23.976)"
"Replay_Res_720p"	"720p (1280 x 720 x 23.967)"
"[english]Replay_Res_720p"	"720p (1280 x 720 x 23.967)"
"Replay_Res_1080p"	"1080p (1920 x 1080 x 23.976)"
"[english]Replay_Res_1080p"	"1080p (1920 x 1080 x 23.976)"
"Replay_Res_Web"	"Web (320 x 240 x 15)"
"[english]Replay_Res_Web"	"Web (320 x 240 x 15)"
"Replay_Res_iPhone_Horizontal"	"iPhone chiều ngang (960 x 640 x 23.976)"
"[english]Replay_Res_iPhone_Horizontal"	"iPhone Horizontal (960 x 640 x 23.976)"
"Replay_Res_iPhone_Vertical"	"iPhone chiều dọc (640 x 960 x 23.976)"
"[english]Replay_Res_iPhone_Vertical"	"iPhone Vertical (640 x 960 x 23.976)"
"Month_1"	"Tháng một"
"[english]Month_1"	"January"
"Month_2"	"Tháng hai"
"[english]Month_2"	"February"
"Month_3"	"Tháng ba"
"[english]Month_3"	"March"
"Month_4"	"Tháng tư"
"[english]Month_4"	"April"
"Month_5"	"Tháng năm"
"[english]Month_5"	"May"
"Month_6"	"Tháng sáu"
"[english]Month_6"	"June"
"Month_7"	"Tháng bảy"
"[english]Month_7"	"July"
"Month_8"	"Tháng tám"
"[english]Month_8"	"August"
"Month_9"	"Tháng chín"
"[english]Month_9"	"September"
"Month_10"	"Tháng mười"
"[english]Month_10"	"October"
"Month_11"	"Tháng mười một"
"[english]Month_11"	"November"
"Month_12"	"Tháng mười hai"
"[english]Month_12"	"December"
"YouTube_UploadProgress"	"%s1% - [ %s2 / %s3 kB ]"
"[english]YouTube_UploadProgress"	"%s1% - [ %s2 / %s3 kB ]"
"YouTube_LoginDlg_UserName"	"Tên đăng nhập"
"[english]YouTube_LoginDlg_UserName"	"Username"
"YouTube_LoginDlg_Password"	"Mật khẩu"
"[english]YouTube_LoginDlg_Password"	"Password"
"YouTube_LoginDlg_Register"	"Đăng ký"
"[english]YouTube_LoginDlg_Register"	"Register"
"YouTube_LoginDlg_Login"	"Đăng nhập"
"[english]YouTube_LoginDlg_Login"	"Login"
"YouTube_UploadDlg_MovieTitle"	"Tiêu đề"
"[english]YouTube_UploadDlg_MovieTitle"	"Title"
"YouTube_UploadDlg_MovieDesc"	"Mô tả"
"[english]YouTube_UploadDlg_MovieDesc"	"Description"
"YouTube_UploadDlg_Terms"	"YouTube T.O.S."
"[english]YouTube_UploadDlg_Terms"	"YouTube T.O.S."
"YouTube_NoStats"	"N/A"
"[english]YouTube_NoStats"	"N/A"
"TR_Spy_WeaponsTitle"	"Vũ khí"
"[english]TR_Spy_WeaponsTitle"	"Weapons"
"TF_Coach_Slot1Label"	"[%slot1%]"
"[english]TF_Coach_Slot1Label"	"[%slot1%]"
"TF_Coach_Slot2Label"	"[%slot2%]"
"[english]TF_Coach_Slot2Label"	"[%slot2%]"
"TF_Coach_StudentRetry_Title"	"Thử lại?"
"[english]TF_Coach_StudentRetry_Title"	"Retry?"
"TF_Coach_AddedCoach_Title"	"Thành công!"
"[english]TF_Coach_AddedCoach_Title"	"Success!"
"TF_Coach_RemovedCoach_Title"	"Thành công!"
"[english]TF_Coach_RemovedCoach_Title"	"Success!"
"TF_Coach_FoundCoach_Title"	"Thành công!"
"[english]TF_Coach_FoundCoach_Title"	"Success!"
"TF_Coach_Yes"	"Có"
"[english]TF_Coach_Yes"	"Yes"
"TF_Coach_No"	"Không"
"[english]TF_Coach_No"	"No"
"TF_vote_yes_binding"	"Có: %s1"
"[english]TF_vote_yes_binding"	"Yes: %s1"
"TF_vote_no_binding"	"Không: %s1"
"[english]TF_vote_no_binding"	"No: %s1"
"TF_vote_yes_tally"	"Có"
"[english]TF_vote_yes_tally"	"Yes"
"TF_vote_no_tally"	"Không"
"[english]TF_vote_no_tally"	"No"
"Store_Team"	"Đội"
"[english]Store_Team"	"Team"
"Vote_notification_view"	"Xem"
"[english]Vote_notification_view"	"View"
"Replay_SetDefaultSetting"	"TÁI LẬP"
"[english]Replay_SetDefaultSetting"	"RESET"
"TF_Training_Desc_OfflinePractice"	"Mài giũa kỹ năng của bạn với máy."
"[english]TF_Training_Desc_OfflinePractice"	"Sharpen your skills on bots."
"TF_OfflinePractice_Players"	"Người chơi:"
"[english]TF_OfflinePractice_Players"	"Players:"
"TF_MM_GenericFailure_Title"	"Lỗi"
"[english]TF_MM_GenericFailure_Title"	"Error"
"TF_MM_GenericFailure"	"Đã có vấn đề kết nối tới máy chủ Steam. Hãy chắc chắn rằng bạn đã đăng nhập trên Steam và vui lòng thử lại sau."
"[english]TF_MM_GenericFailure"	"There was a problem communicating with the Steam servers.  Make sure you are signed on to Steam and try again later."
"TF_Stormspirit_Hat"	"Cái nón ưa thích của Storm Spirit"
"[english]TF_Stormspirit_Hat"	"Storm Spirit's Jolly Hat"
"ItemTypeDescKillEaterAlt"	"(%s2%s3: %s1)"
"[english]ItemTypeDescKillEaterAlt"	"(%s2%s3: %s1)"
"Store_Popular"	"Bán chạy nhất"
"[english]Store_Popular"	"Top Sellers"
"Store_MostPopular"	"Các sản phẩm phổ biến nhất trong ngày:"
"[english]Store_MostPopular"	"Today's Most Popular Items:"
"Econ_Bundle_Separator"	", "
"[english]Econ_Bundle_Separator"	", "
"TF_Package_Type"	"Gói"
"[english]TF_Package_Type"	"Package"
"TF_EngineerHat2"	"Bộ kính thực tế ảo"
"[english]TF_EngineerHat2"	"The Virtual Reality Headset"
"Attrib_ExpirationDate"	"Vật phẩm này sẽ biến mất vào %s1."
"[english]Attrib_ExpirationDate"	"This item will expire on %s1."
"Store_LearnMore"	"TÌM HIỂU THÊM"
"[english]Store_LearnMore"	"LEARN MORE"
"TF_SteamWorkshop_Delete"	"Xóa"
"[english]TF_SteamWorkshop_Delete"	"Delete"
"TF_SteamWorkshop_Tag_Weapon"	"Vũ khí"
"[english]TF_SteamWorkshop_Tag_Weapon"	"Weapon"
"TF_Hwn_DemoHat_Desc"	""
"[english]TF_Hwn_DemoHat_Desc"	""
"TF_Hwn_DemoMisc1_Desc"	""
"[english]TF_Hwn_DemoMisc1_Desc"	""
"TF_Hwn_DemoMisc2_Desc"	""
"[english]TF_Hwn_DemoMisc2_Desc"	""
"TF_Hwn_ScoutHat_Desc"	""
"[english]TF_Hwn_ScoutHat_Desc"	""
"TF_Hwn_ScoutMisc1_Desc"	""
"[english]TF_Hwn_ScoutMisc1_Desc"	""
"TF_Hwn_ScoutMisc2_Desc"	""
"[english]TF_Hwn_ScoutMisc2_Desc"	""
"TF_Hwn_PyroHat_Desc"	""
"[english]TF_Hwn_PyroHat_Desc"	""
"TF_Hwn_PyroMisc1_Desc"	""
"[english]TF_Hwn_PyroMisc1_Desc"	""
"TF_Hwn_PyroMisc2_Desc"	""
"[english]TF_Hwn_PyroMisc2_Desc"	""
"TF_Hwn_MedicHat_Desc"	""
"[english]TF_Hwn_MedicHat_Desc"	""
"TF_Hwn_MedicMisc1_Desc"	""
"[english]TF_Hwn_MedicMisc1_Desc"	""
"TF_Hwn_MedicMisc2_Desc"	""
"[english]TF_Hwn_MedicMisc2_Desc"	""
"TF_Hwn_SoldierHat_Desc"	""
"[english]TF_Hwn_SoldierHat_Desc"	""
"TF_Hwn_SoldierMisc1_Desc"	""
"[english]TF_Hwn_SoldierMisc1_Desc"	""
"TF_Hwn_SoldierMisc2_Desc"	""
"[english]TF_Hwn_SoldierMisc2_Desc"	""
"TF_Hwn_SpyHat_Desc"	""
"[english]TF_Hwn_SpyHat_Desc"	""
"TF_Hwn_SpyMisc1_Desc"	""
"[english]TF_Hwn_SpyMisc1_Desc"	""
"TF_Hwn_SpyMisc2_Desc"	""
"[english]TF_Hwn_SpyMisc2_Desc"	""
"TF_Hwn_HeavyHat_Desc"	""
"[english]TF_Hwn_HeavyHat_Desc"	""
"TF_Hwn_HeavyMisc1_Desc"	""
"[english]TF_Hwn_HeavyMisc1_Desc"	""
"TF_Hwn_HeavyMisc2_Desc"	""
"[english]TF_Hwn_HeavyMisc2_Desc"	""
"TF_Hwn_SniperHat_Desc"	""
"[english]TF_Hwn_SniperHat_Desc"	""
"TF_Hwn_SniperMisc1_Desc"	""
"[english]TF_Hwn_SniperMisc1_Desc"	""
"TF_Hwn_SniperMisc2_Desc"	""
"[english]TF_Hwn_SniperMisc2_Desc"	""
"TF_Hwn_EngineerHat_Desc"	""
"[english]TF_Hwn_EngineerHat_Desc"	""
"TF_Hwn_EngineerMisc1_Desc"	""
"[english]TF_Hwn_EngineerMisc1_Desc"	""
"TF_Hwn_EngineerMisc2_Desc"	""
"[english]TF_Hwn_EngineerMisc2_Desc"	""
"TF_Hwn_PyroGasmask_DESC"	""
"[english]TF_Hwn_PyroGasmask_DESC"	""
"TF_Ghost_Aspect_Desc"	""
"[english]TF_Ghost_Aspect_Desc"	""
"TF_HalloweenItem_Reserved_Purgatory"	"Một món quà Halloween hắc ám đã bí ẩn xuất hiện ở đâu đó phía bên dưới, được đặt ngay cho ngươi ... hãy đi và tìm nó!"
"[english]TF_HalloweenItem_Reserved_Purgatory"	"A Haunted Halloween Gift has mysteriously appeared somewhere down below, placed just for you... go and find it!"
"TF_Saint_Pin_Desc"	""
"[english]TF_Saint_Pin_Desc"	""
"TF_Bowtie_Desc"	""
"[english]TF_Bowtie_Desc"	""
"TF_Tag_Category_Misc"	""
"[english]TF_Tag_Category_Misc"	""
"TF_SomethingSpecial_Desc"	""
"[english]TF_SomethingSpecial_Desc"	""
"TF_MapperMedal_Desc"	""
"[english]TF_MapperMedal_Desc"	""
"TF_WeddingRing_AcceptProposal"	"Tôi đồng ý!"
"[english]TF_WeddingRing_AcceptProposal"	"I do!"
"TF_CozyCamper_Desc"	""
"[english]TF_CozyCamper_Desc"	""
"TF_ValveStoreShipmentBox_Desc"	""
"[english]TF_ValveStoreShipmentBox_Desc"	""
"TF_RobotChickenHat_Promo_Desc"	""
"[english]TF_RobotChickenHat_Promo_Desc"	""
"TF_Weapon_PEP_Scattergun_Desc"	""
"[english]TF_Weapon_PEP_Scattergun_Desc"	""
"TF_Weapon_PEP_Pistol_Desc"	""
"[english]TF_Weapon_PEP_Pistol_Desc"	""
"TF_DS_DumpsterDevice_Desc"	""
"[english]TF_DS_DumpsterDevice_Desc"	""
"TF_Pro_SMG_Desc"	""
"[english]TF_Pro_SMG_Desc"	""
"TF_TournamentMedal_ESL_SeasonVI_Premier"	""
"[english]TF_TournamentMedal_ESL_SeasonVI_Premier"	""
"TF_TournamentMedal_ESL_SeasonVI_Div1"	""
"[english]TF_TournamentMedal_ESL_SeasonVI_Div1"	""
"TF_TournamentMedal_ESL_SeasonVI_Div2"	""
"[english]TF_TournamentMedal_ESL_SeasonVI_Div2"	""
"TF_TournamentMedal_ESL_SeasonVI_Div3"	""
"[english]TF_TournamentMedal_ESL_SeasonVI_Div3"	""
"TF_TournamentMedal_ESL_SeasonVI_Div4"	""
"[english]TF_TournamentMedal_ESL_SeasonVI_Div4"	""
"TF_TournamentMedal_ESL_SeasonVI_Div5"	""
"[english]TF_TournamentMedal_ESL_SeasonVI_Div5"	""
"TF_TournamentMedal_ESL_SeasonVII_Premiership"	""
"[english]TF_TournamentMedal_ESL_SeasonVII_Premiership"	""
"TF_TournamentMedal_ESL_SeasonVII_Div1"	""
"[english]TF_TournamentMedal_ESL_SeasonVII_Div1"	""
"TF_TournamentMedal_ESL_SeasonVII_Div2"	""
"[english]TF_TournamentMedal_ESL_SeasonVII_Div2"	""
"TF_TournamentMedal_ESL_SeasonVII_Div3"	""
"[english]TF_TournamentMedal_ESL_SeasonVII_Div3"	""
"TF_TournamentMedal_ESL_SeasonVII_Div4"	""
"[english]TF_TournamentMedal_ESL_SeasonVII_Div4"	""
"TF_TournamentMedal_ESL_SeasonVII_Div5"	""
"[english]TF_TournamentMedal_ESL_SeasonVII_Div5"	""
"TF_Pet_Balloonicorn_Promo_Desc"	""
"[english]TF_Pet_Balloonicorn_Promo_Desc"	""
"TF_Sandvich_Promo_Desc"	""
"[english]TF_Sandvich_Promo_Desc"	""
"TF_Companion_Square_Promo_Desc"	""
"[english]TF_Companion_Square_Promo_Desc"	""
"TF_Matchmaking_Players"	"Người chơi trong hàng chờ:"
"[english]TF_Matchmaking_Players"	"Players in queue:"
"TF_PVE_UsePowerup_MinMode"	"'%use_action_slot_item%' để kích hoạt"
"[english]TF_PVE_UsePowerup_MinMode"	"'%use_action_slot_item%' to Activate"
"TF_MvM_TourOfDuty"	"Tour of Duty"
"[english]TF_MvM_TourOfDuty"	"Tour of Duty"
"TF_MvM_TourOfDutyProgress"	"Tiến trình"
"[english]TF_MvM_TourOfDutyProgress"	"Progress"
"TF_BigPictureGameController_Ask_Text"	"Tôi nhận ra bạn đang chạy chế độ Big Picture. Bạn có muốn bật tính năng hỗ trợ tay cầm không?"
"[english]TF_BigPictureGameController_Ask_Text"	"I noticed you are running under Big Picture. Would you like to enable game controller support?"
"TF_MannCoOnlineCap_Desc"	""
"[english]TF_MannCoOnlineCap_Desc"	""
"TF_Pet_BalloonicornPlush_Promo_Desc"	""
"[english]TF_Pet_BalloonicornPlush_Promo_Desc"	""
"TF_TournamentMedal_Empty_Desc"	""
"[english]TF_TournamentMedal_Empty_Desc"	""
"TF_LinuxItem"	"Tux"
"[english]TF_LinuxItem"	"Tux"
"TF_ImportFile_Verify"	"Xác nhận"
"[english]TF_ImportFile_Verify"	"Verify"
"TF_OculusRift_Promo_Desc"	""
"[english]TF_OculusRift_Promo_Desc"	""
"TF_VR_LessLots"	"<<"
"[english]TF_VR_LessLots"	"<<"
"TF_VR_Less"	"<"
"[english]TF_VR_Less"	"<"
"TF_VR_More"	">"
"[english]TF_VR_More"	">"
"TF_VR_MoreLots"	">>"
"[english]TF_VR_MoreLots"	">>"
"TF_ImportFile_Warning"	"Cảnh báo!"
"[english]TF_ImportFile_Warning"	"Warning!"
"TF_HUD_ServerTimeLeft"	"%s1:%s2:%s3"
"[english]TF_HUD_ServerTimeLeft"	"%s1:%s2:%s3"
"TF_HUD_ServerTimeLeftNoHours"	"%s1:%s2"
"[english]TF_HUD_ServerTimeLeftNoHours"	"%s1:%s2"
"TF_HUD_ServerChangeOnRoundEnd"	"00:00"
"[english]TF_HUD_ServerChangeOnRoundEnd"	"00:00"
"TF_Mysterious_Promo10_Desc"	""
"[english]TF_Mysterious_Promo10_Desc"	""
"TF_Prompt_Romevsion_OK"	"Có"
"[english]TF_Prompt_Romevsion_OK"	"Yes"
"GameUI_HudPlayerClassUsePlayerModelDialogConfirm"	"Có"
"[english]GameUI_HudPlayerClassUsePlayerModelDialogConfirm"	"Yes"
"GameUI_HudPlayerClassUsePlayerModelDialogCancel"	"Không"
"[english]GameUI_HudPlayerClassUsePlayerModelDialogCancel"	"No"
"ItemNameToolTargetNameFormat"	"%s1 "
"[english]ItemNameToolTargetNameFormat"	"%s1 "
"ItemNameDynamicRecipeTargetNameFormat"	"%s1 "
"[english]ItemNameDynamicRecipeTargetNameFormat"	"%s1 "
"TF_Chess_Promo_Desc"	""
"[english]TF_Chess_Promo_Desc"	""
"TF_fall2013_the_special_eyes_Desc"	""
"[english]TF_fall2013_the_special_eyes_Desc"	""
"TF_fall2013_kyoto_rider_Desc"	""
"[english]TF_fall2013_kyoto_rider_Desc"	""
"TF_fall2013_aichi_investigator_Desc"	""
"[english]TF_fall2013_aichi_investigator_Desc"	""
"TF_fall2013_brimfull_of_bullets_Desc"	""
"[english]TF_fall2013_brimfull_of_bullets_Desc"	""
"TF_fall2013_the_cotton_head_Desc"	""
"[english]TF_fall2013_the_cotton_head_Desc"	""
"TF_fall2013_popeyes_Desc"	""
"[english]TF_fall2013_popeyes_Desc"	""
"TF_fall2013_hong_kong_cone_Desc"	""
"[english]TF_fall2013_hong_kong_cone_Desc"	""
"TF_fall2013_weight_room_warmer_Desc"	""
"[english]TF_fall2013_weight_room_warmer_Desc"	""
"TF_fall2013_pirate_bandana_Desc"	""
"[english]TF_fall2013_pirate_bandana_Desc"	""
"TF_fall2013_escapist_Desc"	""
"[english]TF_fall2013_escapist_Desc"	""
"TF_fall2013_neo_tokyo_runner_Desc"	""
"[english]TF_fall2013_neo_tokyo_runner_Desc"	""
"TF_fall2013_medic_wc_beard_Desc"	""
"[english]TF_fall2013_medic_wc_beard_Desc"	""
"TF_fall2013_medic_wc_hair_Desc"	""
"[english]TF_fall2013_medic_wc_hair_Desc"	""
"TF_fall2013_spy_fancycoat_Desc"	""
"[english]TF_fall2013_spy_fancycoat_Desc"	""
"TF_fall2013_medic_wc_coat_Desc"	""
"[english]TF_fall2013_medic_wc_coat_Desc"	""
"TF_hw2013_beast_from_below_Desc"	""
"[english]TF_hw2013_beast_from_below_Desc"	""
"TF_hw2013_hardheaded_hardware_Desc"	""
"[english]TF_hw2013_hardheaded_hardware_Desc"	""
"TF_hw2013_octo_face_Desc"	""
"[english]TF_hw2013_octo_face_Desc"	""
"TF_hw2013_space_oddity_Desc"	""
"[english]TF_hw2013_space_oddity_Desc"	""
"TF_hw2013_ethereal_hood_Desc"	""
"[english]TF_hw2013_ethereal_hood_Desc"	""
"TF_hw2013_maniacs_manacles_Desc"	""
"[english]TF_hw2013_maniacs_manacles_Desc"	""
"TF_hw2013_second_opinion_Desc"	""
"[english]TF_hw2013_second_opinion_Desc"	""
"TF_hw2013_allclass_horseman_Desc"	""
"[english]TF_hw2013_allclass_horseman_Desc"	""
"TF_hw2013_last_bite_Desc"	""
"[english]TF_hw2013_last_bite_Desc"	""
"TF_hw2013_scout_demo_faunlegs_Desc"	""
"[english]TF_hw2013_scout_demo_faunlegs_Desc"	""
"TF_hw2013_dragon_hood_Desc"	""
"[english]TF_hw2013_dragon_hood_Desc"	""
"TF_hw2013_golden_crisp_locks_Desc"	""
"[english]TF_hw2013_golden_crisp_locks_Desc"	""
"TF_hw2013_scorched_skirt_Desc"	""
"[english]TF_hw2013_scorched_skirt_Desc"	""
"TF_hw2013_wandering_soul_Desc"	""
"[english]TF_hw2013_wandering_soul_Desc"	""
"TF_hw2013_horrifying_hound_hood_Desc"	""
"[english]TF_hw2013_horrifying_hound_hood_Desc"	""
"TF_hw2013_terrifying_terrier_trousers_Desc"	""
"[english]TF_hw2013_terrifying_terrier_trousers_Desc"	""
"TF_hw2013_bunny_mann_Desc"	""
"[english]TF_hw2013_bunny_mann_Desc"	""
"TF_hw2013_leather_face_Desc"	""
"[english]TF_hw2013_leather_face_Desc"	""
"TF_hw2013_per_eye_scopes_Desc"	""
"[english]TF_hw2013_per_eye_scopes_Desc"	""
"TF_hw2013_stiff_buddy_Desc"	""
"[english]TF_hw2013_stiff_buddy_Desc"	""
"TF_hw2013_tricky_chicken_Desc"	""
"[english]TF_hw2013_tricky_chicken_Desc"	""
"TF_hw2013_dark_orchestra_Desc"	""
"[english]TF_hw2013_dark_orchestra_Desc"	""
"TF_hw2013_ivan_the_inedible_Desc"	""
"[english]TF_hw2013_ivan_the_inedible_Desc"	""
"TF_hw2013_rugged_respirator_Desc"	""
"[english]TF_hw2013_rugged_respirator_Desc"	""
"TF_hw2013_blackguards_bicorn_Desc"	""
"[english]TF_hw2013_blackguards_bicorn_Desc"	""
"TF_hw2013_hollowhead_Desc"	""
"[english]TF_hw2013_hollowhead_Desc"	""
"TF_hw2013_combat_maggots_Desc"	""
"[english]TF_hw2013_combat_maggots_Desc"	""
"TF_hw2013_gothic_guise_Desc"	""
"[english]TF_hw2013_gothic_guise_Desc"	""
"TF_hw2013_grease_monkey_Desc"	""
"[english]TF_hw2013_grease_monkey_Desc"	""
"TF_hw2013_witching_ward_Desc"	""
"[english]TF_hw2013_witching_ward_Desc"	""
"TF_hw2013_dragonbutt_Desc"	""
"[english]TF_hw2013_dragonbutt_Desc"	""
"TF_hw2013_zombie_parrot_Desc"	""
"[english]TF_hw2013_zombie_parrot_Desc"	""
"TF_hw2013_faux_manchu_Desc"	""
"[english]TF_hw2013_faux_manchu_Desc"	""
"TF_hw2013_hidden_dragon_Desc"	""
"[english]TF_hw2013_hidden_dragon_Desc"	""
"TF_hw2013_moon_boots_Desc"	""
"[english]TF_hw2013_moon_boots_Desc"	""
"TF_hw2013_spacemans_suit_Desc"	""
"[english]TF_hw2013_spacemans_suit_Desc"	""
"TF_hw2013_boston_bandy_mask_Desc"	""
"[english]TF_hw2013_boston_bandy_mask_Desc"	""
"TF_hw2013_das_blutliebhaber_Desc"	""
"[english]TF_hw2013_das_blutliebhaber_Desc"	""
"TF_hw2013_quacks_cureall_Desc"	""
"[english]TF_hw2013_quacks_cureall_Desc"	""
"TF_hw2013_burlap_buddy_Desc"	""
"[english]TF_hw2013_burlap_buddy_Desc"	""
"TF_hw2013_mucus_membrane_Desc"	""
"[english]TF_hw2013_mucus_membrane_Desc"	""
"TF_hw2013_volatile_voodoo_Desc"	""
"[english]TF_hw2013_volatile_voodoo_Desc"	""
"TF_hw2013_medicmedes_Desc"	""
"[english]TF_hw2013_medicmedes_Desc"	""
"TF_hw2013_heavy_robin_Desc"	""
"[english]TF_hw2013_heavy_robin_Desc"	""
"TF_hw2013_feathered_freedom_Desc"	""
"[english]TF_hw2013_feathered_freedom_Desc"	""
"TF_hw2013_demo_executioner_hood_Desc"	""
"[english]TF_hw2013_demo_executioner_hood_Desc"	""
"TF_hw2013_demon_fro_Desc"	""
"[english]TF_hw2013_demon_fro_Desc"	""
"TF_hw2013_kindlin_candles_Desc"	""
"[english]TF_hw2013_kindlin_candles_Desc"	""
"TF_hw2013_demo_cape_Desc"	""
"[english]TF_hw2013_demo_cape_Desc"	""
"TF_hw2013_the_haha_hairdo_Desc"	""
"[english]TF_hw2013_the_haha_hairdo_Desc"	""
"TF_hw2013_the_hell_runner_Desc"	""
"[english]TF_hw2013_the_hell_runner_Desc"	""
"TF_hw2013_halloweiner_Desc"	""
"[english]TF_hw2013_halloweiner_Desc"	""
"TF_hw2013_the_ghoulic_extension_Desc"	""
"[english]TF_hw2013_the_ghoulic_extension_Desc"	""
"TF_hw2013_soldier_jiangshi_hat_Desc"	""
"[english]TF_hw2013_soldier_jiangshi_hat_Desc"	""
"TF_hw2013_the_fire_bat_v2_Desc"	""
"[english]TF_hw2013_the_fire_bat_v2_Desc"	""
"TF_hw2013_running_octopus_Desc"	""
"[english]TF_hw2013_running_octopus_Desc"	""
"TF_hw2013_intergalactic_intruder_Desc"	""
"[english]TF_hw2013_intergalactic_intruder_Desc"	""
"TF_hw2013_the_enlightening_lantern_Desc"	""
"[english]TF_hw2013_the_enlightening_lantern_Desc"	""
"TF_hw2013_brain__bowler_Desc"	""
"[english]TF_hw2013_brain__bowler_Desc"	""
"TF_hw2013_tin_can_Desc"	""
"[english]TF_hw2013_tin_can_Desc"	""
"TF_hw2013_zombie_chameleon_Desc"	""
"[english]TF_hw2013_zombie_chameleon_Desc"	""
"TF_hw2013_dragon_shoes_Desc"	""
"[english]TF_hw2013_dragon_shoes_Desc"	""
"TF_hw2013_blood_banker_Desc"	""
"[english]TF_hw2013_blood_banker_Desc"	""
"TF_hw2013_harmburg_Desc"	""
"[english]TF_hw2013_harmburg_Desc"	""
"TF_hw2013_medic_undertaker_vest_Desc"	""
"[english]TF_hw2013_medic_undertaker_vest_Desc"	""
"TF_hw2013_rocket_ranger_Desc"	""
"[english]TF_hw2013_rocket_ranger_Desc"	""
"TF_hw2013_jupiter_jumpers_Desc"	""
"[english]TF_hw2013_jupiter_jumpers_Desc"	""
"TF_hw2013_galactic_gauntlets_Desc"	""
"[english]TF_hw2013_galactic_gauntlets_Desc"	""
"TF_hw2013_handhunter_Desc"	""
"[english]TF_hw2013_handhunter_Desc"	""
"TF_hw2013_the_crit_wizard_Desc"	""
"[english]TF_hw2013_the_crit_wizard_Desc"	""
"TF_hw2013_the_creeps_cowl_Desc"	""
"[english]TF_hw2013_the_creeps_cowl_Desc"	""
"TF_hw2013_shamans_skull_Desc"	""
"[english]TF_hw2013_shamans_skull_Desc"	""
"TF_hw2013_head_of_the_lake_monster_Desc"	""
"[english]TF_hw2013_head_of_the_lake_monster_Desc"	""
"TF_hw2013_pumpkin_top_Desc"	""
"[english]TF_hw2013_pumpkin_top_Desc"	""
"TF_hw2013_horned_honcho_Desc"	""
"[english]TF_hw2013_horned_honcho_Desc"	""
"TF_hw2013_zombites_Desc"	""
"[english]TF_hw2013_zombites_Desc"	""
"TF_hw2013_gristly_gumbo_pot_Desc"	""
"[english]TF_hw2013_gristly_gumbo_pot_Desc"	""
"TF_hw2013_the_dark_helm_Desc"	""
"[english]TF_hw2013_the_dark_helm_Desc"	""
"TF_hw2013_zombie_archimedes_Desc"	""
"[english]TF_hw2013_zombie_archimedes_Desc"	""
"TF_hw2013_orcish_outburst_Desc"	""
"[english]TF_hw2013_orcish_outburst_Desc"	""
"TF_hw2013_shaolin_sash_Desc"	""
"[english]TF_hw2013_shaolin_sash_Desc"	""
"TF_hw2013_manbird_of_aberdeen_Desc"	""
"[english]TF_hw2013_manbird_of_aberdeen_Desc"	""
"TF_hw2013_foul_cowl_Desc"	""
"[english]TF_hw2013_foul_cowl_Desc"	""
"TF_hw2013_sir_shootsalot_Desc"	""
"[english]TF_hw2013_sir_shootsalot_Desc"	""
"TF_hw2013_corpsemopolitan_Desc"	""
"[english]TF_hw2013_corpsemopolitan_Desc"	""
"TF_hw2013_the_glob_Desc"	""
"[english]TF_hw2013_the_glob_Desc"	""
"TF_hw2013_the_halloween_headcase_Desc"	""
"[english]TF_hw2013_the_halloween_headcase_Desc"	""
"TF_hw2013_carrion_cohort_Desc"	""
"[english]TF_hw2013_carrion_cohort_Desc"	""
"TF_hw2013_the_caws_of_death_Desc"	""
"[english]TF_hw2013_the_caws_of_death_Desc"	""
"TF_hw2013_py40_automaton_Desc"	""
"[english]TF_hw2013_py40_automaton_Desc"	""
"TF_hw2013_the_parasight_Desc"	""
"[english]TF_hw2013_the_parasight_Desc"	""
"TF_hw2013_teutonkahmun_Desc"	""
"[english]TF_hw2013_teutonkahmun_Desc"	""
"TF_hw2013_mr_maggot_Desc"	""
"[english]TF_hw2013_mr_maggot_Desc"	""
"TF_hw2013_the_manneater_Desc"	""
"[english]TF_hw2013_the_manneater_Desc"	""
"TF_hw2013_the_creature_from_the_heap_Desc"	""
"[english]TF_hw2013_the_creature_from_the_heap_Desc"	""
"TF_hw2013_the_magical_mercenary_Desc"	""
"[english]TF_hw2013_the_magical_mercenary_Desc"	""
"TF_hw2013_visage_of_the_crow_Desc"	""
"[english]TF_hw2013_visage_of_the_crow_Desc"	""
"TF_hw2013_ramses_regalia_Desc"	""
"[english]TF_hw2013_ramses_regalia_Desc"	""
"TF_hw2013_the_haunted_hat_Desc"	""
"[english]TF_hw2013_the_haunted_hat_Desc"	""
"TF_hw2013_rogues_brogues_Desc"	""
"[english]TF_hw2013_rogues_brogues_Desc"	""
"TF_hw2013_all_skull_necklace_Desc"	""
"[english]TF_hw2013_all_skull_necklace_Desc"	""
"TF_hw2013_the_abhorrent_appendages_Desc"	""
"[english]TF_hw2013_the_abhorrent_appendages_Desc"	""
"TF_Wearable_Snowglobe"	"Snow Globe"
"[english]TF_Wearable_Snowglobe"	"Snow Globe"
"TF_TF2mixup_Community_Event_2013_Promo_Desc"	""
"[english]TF_TF2mixup_Community_Event_2013_Promo_Desc"	""
"TF_RobotHeavy_Promo_Desc"	""
"[english]TF_RobotHeavy_Promo_Desc"	""
"TF_FortifiedCompound_Desc"	""
"[english]TF_FortifiedCompound_Desc"	""
"TF_GildedGuard_Desc"	""
"[english]TF_GildedGuard_Desc"	""
"TF_CriminalCloak_Desc"	""
"[english]TF_CriminalCloak_Desc"	""
"TF_DreadHidingHood_Desc"	""
"[english]TF_DreadHidingHood_Desc"	""
"TF_BaronialBadge_Desc"	""
"[english]TF_BaronialBadge_Desc"	""
"TF_ToweringPillarOfSummerShades_Desc"	""
"[english]TF_ToweringPillarOfSummerShades_Desc"	""
"TF_Summer2014_Level1"	"Gói Summer Adventure"
"[english]TF_Summer2014_Level1"	"Summer Adventure Pack"
"TF_ScoutFancyShirt_Desc"	""
"[english]TF_ScoutFancyShirt_Desc"	""
"TF_ScoutFancyShoes_Desc"	""
"[english]TF_ScoutFancyShoes_Desc"	""
"TF_ScoutFancyHair_Desc"	""
"[english]TF_ScoutFancyHair_Desc"	""
"TF_DemoSombrero_Desc"	""
"[english]TF_DemoSombrero_Desc"	""
"TF_DemomanMargaritaShades_Desc"	""
"[english]TF_DemomanMargaritaShades_Desc"	""
"TF_DemomanBeerGrenades_Desc"	""
"[english]TF_DemomanBeerGrenades_Desc"	""
"TF_Weapon_BackScatter_Desc"	""
"[english]TF_Weapon_BackScatter_Desc"	""
"TF_Weapon_AirStrike_Desc"	""
"[english]TF_Weapon_AirStrike_Desc"	""
"TF_ClassicSniperRifle_Desc"	""
"[english]TF_ClassicSniperRifle_Desc"	""
"TF_Spycrab_Promo_Desc"	""
"[english]TF_Spycrab_Promo_Desc"	""
"TF_spycrab_Desc"	""
"[english]TF_spycrab_Desc"	""
"TF_RPS_Promo_Desc"	""
"[english]TF_RPS_Promo_Desc"	""
"TF_Horace_Desc"	""
"[english]TF_Horace_Desc"	""
"TF_XenoSuit_Desc"	""
"[english]TF_XenoSuit_Desc"	""
"TF_AlienCranium_Desc"	""
"[english]TF_AlienCranium_Desc"	""
"TF_BiomechBackpack_Desc"	""
"[english]TF_BiomechBackpack_Desc"	""
"TF_NostromoNapalmer_Desc"	""
"[english]TF_NostromoNapalmer_Desc"	""
"TF_MK50_Desc"	""
"[english]TF_MK50_Desc"	""
"TF_AI_Promo_Desc"	""
"[english]TF_AI_Promo_Desc"	""
"TF_Weapon_Necro_Smasher_Desc"	""
"[english]TF_Weapon_Necro_Smasher_Desc"	""
"TF_RobotPyro_Promo_Desc"	""
"[english]TF_RobotPyro_Promo_Desc"	""
"TF_Nabler_Desc"	""
"[english]TF_Nabler_Desc"	""
"TF_TF2mixup_Community_Event_2014_Promo_Desc"	""
"[english]TF_TF2mixup_Community_Event_2014_Promo_Desc"	""
"Journal_DuckBadge0"	""
"[english]Journal_DuckBadge0"	""
"TF_CrossingGuard_Desc"	""
"[english]TF_CrossingGuard_Desc"	""
"TF_EOTL_medal_Desc"	""
"[english]TF_EOTL_medal_Desc"	""
"Attrib_AutoFiresWhenFull"	""
"[english]Attrib_AutoFiresWhenFull"	""
"TF_tr_jungle_booty_Desc"	""
"[english]TF_tr_jungle_booty_Desc"	""
"TF_tr_crown_of_the_old_kingdom_Desc"	""
"[english]TF_tr_crown_of_the_old_kingdom_Desc"	""
"TF_tomb_readers_Desc"	""
"[english]TF_tomb_readers_Desc"	""
"TF_tr_bootenkhamuns_Desc"	""
"[english]TF_tr_bootenkhamuns_Desc"	""
"TF_tr_orions_belt_Desc"	""
"[english]TF_tr_orions_belt_Desc"	""
"TF_pocket_raiders_Desc"	""
"[english]TF_pocket_raiders_Desc"	""
"TF_LackOfCheckmark"	""
"[english]TF_LackOfCheckmark"	""
"TFUI_InvTooltip_None"	""
"[english]TFUI_InvTooltip_None"	""
"TF_JingleJam_Community_Event_2015_Promo_Desc"	""
"[english]TF_JingleJam_Community_Event_2015_Promo_Desc"	""
"TF_Bundle_BatmanArkhamKnightPromo_Desc"	""
"[english]TF_Bundle_BatmanArkhamKnightPromo_Desc"	""
"TF_dec15_a_well_wrapped_hat_desc"	""
"[english]TF_dec15_a_well_wrapped_hat_desc"	""
"TF_dec15_gift_bringer_desc"	""
"[english]TF_dec15_gift_bringer_desc"	""
"TF_dec15_chill_chullo_desc"	""
"[english]TF_dec15_chill_chullo_desc"	""
"TF_dec15_scout_baseball_bag_desc"	""
"[english]TF_dec15_scout_baseball_bag_desc"	""
"TF_dec15_winter_backup_desc"	""
"[english]TF_dec15_winter_backup_desc"	""
"TF_dec15_hot_heels_desc"	""
"[english]TF_dec15_hot_heels_desc"	""
"TF_dec15_heavy_sweater_desc"	""
"[english]TF_dec15_heavy_sweater_desc"	""
"TF_dec15_chicago_overcoat_desc"	""
"[english]TF_dec15_chicago_overcoat_desc"	""
"TF_dec15_patriot_peak_desc"	""
"[english]TF_dec15_patriot_peak_desc"	""
"TF_dec15_diplomat_desc"	""
"[english]TF_dec15_diplomat_desc"	""
"TF_dec15_bunnyhoppers_ballistics_vest_desc"	""
"[english]TF_dec15_bunnyhoppers_ballistics_vest_desc"	""
"TF_dec15_berlin_brain_bowl_desc"	""
"[english]TF_dec15_berlin_brain_bowl_desc"	""
"TF_dec15_medic_winter_jacket2_emblem_desc"	""
"[english]TF_dec15_medic_winter_jacket2_emblem_desc"	""
"TF_dec15_a_hat_to_kill_for_desc"	""
"[english]TF_dec15_a_hat_to_kill_for_desc"	""
"TF_dec15_shin_shredders_desc"	""
"[english]TF_dec15_shin_shredders_desc"	""
"TF_may16_airdog_desc"	""
"[english]TF_may16_airdog_desc"	""
"TF_may16_bedouin_bandana_desc"	""
"[english]TF_may16_bedouin_bandana_desc"	""
"TF_may16_heralds_helm_desc"	""
"[english]TF_may16_heralds_helm_desc"	""
"TF_may16_courtly_cuirass_desc"	""
"[english]TF_may16_courtly_cuirass_desc"	""
"TF_may16_squires_sabatons_desc"	""
"[english]TF_may16_squires_sabatons_desc"	""
"TF_may16_surgical_survivalist_desc"	""
"[english]TF_may16_surgical_survivalist_desc"	""
"TF_may16_skullcap_desc"	""
"[english]TF_may16_skullcap_desc"	""
"TF_may16_lurking_legionnaire_desc"	""
"[english]TF_may16_lurking_legionnaire_desc"	""
"TF_may16_dayjogger_desc"	""
"[english]TF_may16_dayjogger_desc"	""
"TF_may16_patriots_pouches_desc"	""
"[english]TF_may16_patriots_pouches_desc"	""
"TF_may16_dad_duds_desc"	""
"[english]TF_may16_dad_duds_desc"	""
"TF_may16_gauzed_gaze_desc"	""
"[english]TF_may16_gauzed_gaze_desc"	""
"TF_may16_demos_dustcatcher_desc"	""
"[english]TF_may16_demos_dustcatcher_desc"	""
"TF_may16_scoped_spartan_desc"	""
"[english]TF_may16_scoped_spartan_desc"	""
"TF_prinny_machete_Desc"	""
"[english]TF_prinny_machete_Desc"	""
"TF_prinny_pouch_Desc"	""
"[english]TF_prinny_pouch_Desc"	""
"TF_prinny_hat_Desc"	""
"[english]TF_prinny_hat_Desc"	""
"TF_hwn2016_colossal_cranium_2_Desc"	""
"[english]TF_hwn2016_colossal_cranium_2_Desc"	""
"TF_hwn2016_aerobatics_demonstrator_Desc"	""
"[english]TF_hwn2016_aerobatics_demonstrator_Desc"	""
"TF_hwn2016_final_frontiersman_Desc"	""
"[english]TF_hwn2016_final_frontiersman_Desc"	""
"TF_hwn2016_hovering_hotshot_Desc"	""
"[english]TF_hwn2016_hovering_hotshot_Desc"	""
"TF_hwn2016_toadstool_topper_Desc"	""
"[english]TF_hwn2016_toadstool_topper_Desc"	""
"TF_hwn2016_showstopper_Desc"	""
"[english]TF_hwn2016_showstopper_Desc"	""
"TF_hwn2016_big_topper_Desc"	""
"[english]TF_hwn2016_big_topper_Desc"	""
"TF_hwn2016_combustible_cutie_Desc"	""
"[english]TF_hwn2016_combustible_cutie_Desc"	""
"TF_hwn2016_pyro_shark_Desc"	""
"[english]TF_hwn2016_pyro_shark_Desc"	""
"TF_hwn2016_spooktacles_Desc"	""
"[english]TF_hwn2016_spooktacles_Desc"	""
"TF_hwn2016_improv_coonskin_cap_Desc"	""
"[english]TF_hwn2016_improv_coonskin_cap_Desc"	""
"TF_hwn2016_heavy_tourism_Desc"	""
"[english]TF_hwn2016_heavy_tourism_Desc"	""
"TF_hwn2016_el_paso_poncho_Desc"	""
"[english]TF_hwn2016_el_paso_poncho_Desc"	""
"TF_hwn2016_wide_brimmed_bandito_Desc"	""
"[english]TF_hwn2016_wide_brimmed_bandito_Desc"	""
"TF_hwn2016_corpus_christi_cranium_Desc"	""
"[english]TF_hwn2016_corpus_christi_cranium_Desc"	""
"TF_hwn2016_spirit_of_the_bombing_past_Desc"	""
"[english]TF_hwn2016_spirit_of_the_bombing_past_Desc"	""
"TF_hwn2016_class_crown_Desc"	""
"[english]TF_hwn2016_class_crown_Desc"	""
"TF_hwn2016_wing_mann_Desc"	""
"[english]TF_hwn2016_wing_mann_Desc"	""
"TF_hwn2016_nasty_norsemann_Desc"	""
"[english]TF_hwn2016_nasty_norsemann_Desc"	""
"TF_hwn2016_pestering_jester_Desc"	""
"[english]TF_hwn2016_pestering_jester_Desc"	""
"TF_hwn2016_mo_horn_Desc"	""
"[english]TF_hwn2016_mo_horn_Desc"	""
"TF_hwn2016_surgeons_sidearms_Desc"	""
"[english]TF_hwn2016_surgeons_sidearms_Desc"	""
"TF_hwn2016_lil_bitey_Desc"	""
"[english]TF_hwn2016_lil_bitey_Desc"	""
"TF_hwn2016_mad_mask_Desc"	""
"[english]TF_hwn2016_mad_mask_Desc"	""
"TF_hwn2016_burly_beast_Desc"	""
"[english]TF_hwn2016_burly_beast_Desc"	""
"TF_UnusualCap_Desc"	""
"[english]TF_UnusualCap_Desc"	""
"TF_JingleJam_Community_Event_2016_Promo_Desc"	""
"[english]TF_JingleJam_Community_Event_2016_Promo_Desc"	""
}
}
