"lang"
{
"Language"	"pirate"
"Tokens"
{
"DOTA_Move"	"Order"
"DOTA_UnitQuery"	"Shiver th' timbers o' an object/unit"
"DOTA_ExecuteAbility0"	"First Skill"
"DOTA_ExecuteAbility1"	"Second Skill"
"DOTA_ExecuteAbility2"	"Third Skill"
"DOTA_ExecuteAbility3"	"Fourth Skill"
"DOTA_ExecuteAbility4"	"Fifth Skill"
"DOTA_ExecuteAbility5"	"Ultimate Skill"
"DOTA_RespawnTime"	"Rejoinin' yer crew in %s1 grains o' sand"
"DOTA_RespawnTimeShort"	"Rejoin yer crew in %s1 grains"
"DOTA_UnitLevel"	"Rank %s1"
"DOTA_StrengthStatus"	"%s1 MGT"
"DOTA_STR"	"MGT"
"DOTA_AgilityStatus"	"%s1 NBL"
"DOTA_AGI"	"NBL"
"DOTA_IntellectStatus"	"%s1 WIT"
"DOTA_INT"	"WIT"
"DOTA_DamageStatus"	"%s1 Damage"
"DOTA_ArmorStatus"	"%s1 Armor"
"DOTA_ARMOR"	"ARMOR"
"DOTA_UnitHold"	"Hold Yer Ground!"
"DOTA_UnitStop"	"Hault"
"DOTA_LevelUp"	"RANK UP"
"DOTA_LevelUp_Req"	"Yer Admiral Needs t' Be Rank %s1"
"DOTA_AttributesUp"	"RANK %s1"
"DOTA_Abilities"	"SKILLS"
"DOTA_Items"	"LOOT YER USIN'"
"DOTA_AttribArmor"	"Armor"
"DOTA_AttribDamage"	"Damage"
"DOTA_More"	"MORE"
"DOTA_Developer"	"Craftsman"
"DOTA_NeedMana"	"%s1 grain(s)"
"DOTA_ManaCost"	"RUM PRICE %s1"
"DOTA_Basics"	"TH' ROPES"
"DOTA_Upgrades"	"MAKIN' BETTER"
"DOTA_Attributes"	"ATTRIBUTES"
"DOTA_LevelLabel"	"Rank: %s1"
"DOTA_StackCount"	"Stack Count: %s1"
"DOTA_Charges"	"Uses: %s1"
"DOTA_Health"	"LIFE"
"DOTA_Mana"	"RUM"
"DOTA_Skills"	"CRAFTS"
"DOTA_AttributeFooter"	"DAMAGE: %s1 ARMOR: %s2"
"DOTA_UnitSelection_Title"	"UNIT SELECTION"
"DOTA_SelectHeroAndCenter"	"Pick Admiral an' Center Spyglass"
"DOTA_TabUnit"	"Cycle Through Highlighted Units"
"DOTA_StatTooltip_Header"	"Admiral Attributes:\n\n"
"DOTA_StatTooltip_Strength"	"Might:"
"DOTA_StatTooltip_Agility"	"Nimbleness:"
"DOTA_StatTooltip_Intelligence"	"Wits:"
"DOTA_StatTooltip_PrimaryAttrib"	" Main Attribute\n"
"DOTA_StatTooltip_AgilityBonus"	"- Every 7 tallies buff up yer armor by 1\n- Each tally also increases yer beatin' speed by 1% t' boot\n"
"DOTA_StatTooltip_PrimaryBonus"	"- Each tally increases yer damage by 1\n"
"DOTA_GoodGuys"	"Th' Radiant"
"DOTA_BadGuys"	"Th' Dire"
"DOTA_Towers"	"Crow's Nests Still Standin': %s1"
"DOTA_Barracks"	"Cabins: %s1"
"DOTA_NotAvailable"	"Not 'ere Yet"
"DOTA_MoveForward"	"Spyglass North"
"DOTA_MoveBack"	"Spyglass South"
"DOTA_MoveLeft"	"Spyglass West"
"DOTA_MoveRight"	"Spyglass East"
"DOTA_CameraGrip"	"Spyglass Grip"
"DOTA_HeroSelect"	"Choose Admiral"
"DOTA_HeroCenter"	"Admiral's Quarters"
"DOTA_HeroMoveHome"	"Admiral T' Be Headin' Home"
"DOTA_Escape"	"Flee"
"DOTA_Scoreboard"	"Tallyboard"
"DOTA_Screenshot"	"Paintin'"
"DOTA_Voice"	"Jabberin'"
"DOTA_VoiceLane"	"Jabberin' Lane"
"DOTA_ChatGlobal"	"Port Parley"
"DOTA_ChatTeam"	"Crew Parley"
"DOTA_Learn_Abilities"	"Skill Learn"
"DOTA_Learn_Stats"	"Toughen Up"
"DOTA_UseActionItem_Key"	"Action Loot"
"DOTA_StatTooltip_TotalAttributesSkilled"	"Attributes Rank: "
"DOTA_DmgArmorTooltip_AttackSpeed"	"Attack Speed: "
"DOTA_DmgArmorTooltip_AttackSpeedSeconds"	"s per attack"
"DOTA_DmgArmorTooltip_MoveSpeed"	"Movement Speed: "
"DOTA_DmgArmorTooltip_AttackDamage"	"Attack Damage:"
"DOTA_DmgArmorTooltip_AttackRange"	"Attackin' Range:"
"DOTA_DmgArmorTooltip_Armor"	"Bang-Blockin' Armor: "
"DOTA_DmgArmorTooltip_DmgResist"	"Beatin' Resistance: "
"DOTA_DmgArmorTooltip_MagicArmor"	"Witchcraft Protection: "
"DOTA_DmgArmorTooltip_MagicDmgResist"	"Witchcraft Resistance:"
"DOTA_HeroTaunt_Key"	"Mockin' Loot"
"DOTAUI_AspectNormal"	"4:3"
"DOTAUI_AspectWide16x9"	"16:9"
"DOTAUI_AspectWide16x10"	"16:10"
"DOTAUI_Fullscreen"	"Fullscreen"
"DOTAUI_Window"	"Window"
"DOTAUI_BorderlessWindow"	"Borderless Window"
"DOTA_Welcome"	"Avast ye, an' welcome t' DotA"
"DOTA_Chat_Team"	"[SHIPMATES] %s1: %s2"
"DOTA_Chat_Team_Dead"	"*DEAD*[SHIPMATES] %s1: %s2"
"DOTA_Chat_Spec"	"[Lookout] %s1: %s2"
"DOTA_Chat_All"	"%s1: %s2"
"DOTA_Chat_PlayerKilled"	"%s1 just blast'd off an' bagg'd %s2's head fer %s3 coins!"
"DOTA_Chat_PlayerDenied"	"Arr, %s1 gave mercy t' %s2!"
"DOTA_Chat_PlayerDeniedSelf"	"%s1 just sent themself t' Davy Jones' Locker!"
"DOTA_Chat_PlayerKilledAssist"	"Arr, %s1 has been slain! %s2 coins t' be shared wit' assisters:"
"DOTA_Chat_TowerPlayerKilled"	"%s1 wrecked a crow's nest!"
"DOTA_Chat_TowerKilledGood"	"A crow's nest was wreck'd by Th' Dire!"
"DOTA_Chat_TowerKilledBad"	"A crow's nest was wreck'd by Th' Radiant!"
"DOTA_Chat_BarracksKilled"	"%s1 %s2 %s3 Cabins has been wrecked!"
"DOTA_Chat_TowerDenied"	"%s1 denied a crow's nest!"
"DOTA_Chat_BuyBack"	"%s1 just paid his way out o' Jones' locker an' be kickin' arse yet again!"
"DOTA_Chat_PickedUpAegis"	"%s1 pilfered th' Aegis o' th' Immortal!"
"DOTA_Chat_KilledRoshanGood"	"Th' Kraken has been sent t' Davy Jones' Locker by th' Radiant! %s1 coins t' each admiral o' Th' Radiant!"
"DOTA_Chat_KilledRoshanBad"	"Th' Kraken has been slain by th' Dire! %s1 coins t' each admiral o' Th' Dire!"
"DOTA_Chat_SuperCreepsGood"	"All o' th' Dire Cabins be wrecked. Th' Radiant now be havin' Mega creeps!"
"DOTA_Chat_SuperCreepsBad"	"All o' th' Radiant Cabins be wrecked. Th' Dire now be havin' Mega creeps!"
"DOTA_Chat_Connect"	"%s1 has docked at th' port."
"DOTA_Chat_Disconnect"	"%s1 'as jump'd o'erboard."
"DOTA_Chat_DisconnectTimeRemaining"	"<font color='#FF0000'><b>%s1 has %s2 shots o' rum left t' be back onboard.</b></font>"
"DOTA_Chat_DisconnectTimeRemainingPlural"	"<font color='#FF0000'><b>%s1 has %s2 shots o' rum left t' be back onboard.</b></font>"
"DOTA_Chat_Reconnect"	"%s1 just decided t' come back fer more adventurin'."
"DOTA_Chat_Rune_DoubleDamage"	"%s1 'as activated a <font color='#82CAFF'>Double Damage</font> rune."
"DOTA_Chat_Rune_Haste"	"%s1 'as activated a <font color='#F62817'>Haste</font> rune."
"DOTA_Chat_Rune_Illusion"	"%s1 'as activated an <font color='#FFD700'>Illusion</font> rune."
"DOTA_Chat_Rune_Invisibility"	"%s1 'as activated an <font color='#8B008B'>Invisibility</font> rune."
"DOTA_Chat_Rune_Regeneration"	"%s1 'as activated a <font color='#7FFF00'>Regeneration</font> rune."
"DOTA_Chat_Rune_Bottle_DoubleDamage"	"%s1 'as stuck a <font color='#82CAFF'>Double Damage</font> rune in a bottle."
"DOTA_Chat_Rune_Bottle_Haste"	"%s1 'as stuck a <font color='#F62817'>Haste</font> rune in a bottle."
"DOTA_Chat_Rune_Bottle_Illusion"	"%s1 'as stuck an <font color='#FFD700'>Illusion</font> rune in a bottle."
"DOTA_Chat_Rune_Bottle_Invisibility"	"%s1 'as stuck an <font color='#8B008B'>Invisibility</font> rune in a bottle."
"DOTA_Chat_Rune_Bottle_Regeneration"	"%s1 'as stuck a <font color='#7FFF00'>Regeneration</font> rune in a bottle."
"DOTA_Chat_NoHero"	"No Admiral"
"DOTA_Chat_SecretShop"	"Head t' th' black market t' get yerself a %s1"
"DOTA_Chat_ItemAutoPurchased"	"Th' item %s1 has been aquiered fer ye!"
"DOTA_Chat_ItemsCombined"	"Ye smashed yer pieces o' loot together t' form a %s1!"
"DOTA_Chat_CourierLostGood"	"Radiant's courier be sent t' Davy Jones` Locker!"
"DOTA_Chat_CourierLostBad"	"Dire's courier be sent t' Davy Jones` Locker."
"DOTA_Chat_GlyphUsedGood"	"Radiant structures' be fortified."
"DOTA_Chat_GlyphUsedBad"	"Dire structures' be fortified."
"DOTA_Chat_CantUseActionItem"	"Can't be usin' that thar '%s1' right now - %s2."
"DOTA_Chat_Bot_Gank"	"Invadin' %s1!"
"DOTA_Chat_Bot_PushTower"	"Pushin' %s1"
"DOTA_Chat_Bot_Defend"	"Protectin' %s1"
"DOTA_Chat_Bot_Roam"	"Sailin' t' %s1 t' shank"
"DOTA_Chat_Bot_RoamGank"	"Get on %s1!"
"DOTA_Chat_Bot_RuneTop"	"Be checkin' th' rune above"
"DOTA_Chat_Bot_RuneBottom"	"Be checkin' th' rune below"
"DOTA_Chat_Bot_Roshan"	"Slayin' th' Kraken!"
"DOTA_LaneNameNone"	"base"
"DOTA_LaneNameTop"	"top"
"DOTA_LaneNameMiddle"	"mid"
"DOTA_Chat_ActionItemReason_Unknown"	"ain't th' best of times, right now"
"DOTA_Chat_ActionItemReason_Dead"	"yer dead\nwe ain't suprised\nye shan't be mourned"
"DOTA_MiniKillCam_KillerInfo"	"MURDERED BY\n%s1"
"DOTA_MiniKillCam_ReadytoRespawn"	"Prepare fer yer resurrection!"
"DOTA_MiniKillcam_TotalDamage"	"%s1 DMG"
"DOTA_MiniKillcam_OtherDamage"	"Creep Damage"
"DOTA_MiniKillcam_KilledByGood"	"MURDERED BY\nTh' Radiant!"
"DOTA_MiniKillcam_KilledByBad"	"MURDERED BY\nTh' Dire!"
"DOTA_MiniKillcam_Timer"	"%s1:%s2"
"DOTA_Chat_Good"	"Th' Radiant"
"DOTA_Chat_Bad"	"Th' Dire"
"DOTA_Chat_Melee"	"Close Combat"
"DOTA_Chat_Ranged"	"Ranged"
"DOTA_Chat_LaneTop"	"Top"
"DOTA_Chat_LaneMid"	"Mid"
"DOTA_Chat_LaneBot"	"Bottom"
"DOTA_Lobby_Player_Joined"	"%s1 boarded."
"DOTA_Lobby_Player_Left"	"%s1 disembarked."
"DOTA_Lobby_Become_Leader_Self"	"Yer now in charge o' th' Lobby."
"DOTA_Lobby_Become_Leader"	"%s1 now be in charge o' th' Lobby."
"DOTA_Lobby_Game_Lobby_Setup"	"SEAFARIN' PRACTICE LOBBY RIGGINGS"
"DOTA_Lobby_Game_Mode"	"BATTLE TYPE"
"DOTA_Lobby_Region"	"PORT LOCATION"
"DOTA_Lobby_Team_1_Logo"	"FIRST CREW'S FLAG"
"DOTA_Lobby_Team_2_Logo"	"SECOND CREW'S FLAG"
"DOTA_Lobby_Team_1_Name"	"FIRST CREW'S TITLE"
"DOTA_Lobby_Team_2_Name"	"SECOND CREW'S TITLE"
"DOTA_Lobby_Enable_Cheats"	"Permit cheatin'"
"DOTA_Lobby_Fill_Bots"	"Stuff empty slots wit' dummies"
"DOTA_Lobby_Intro_Mode"	"Intro Mode"
"DOTA_UI_Cancel"	"BELAY"
"DOTA_UI_Ok"	"AYE"
"dota_region_us_west"	"US West"
"dota_region_us_east"	"US East"
"dota_region_europe"	"Luxembourg"
"dota_region_hong_kong"	"Hong Kong"
"dota_region_singapore"	"Singapore"
"dota_region_shanghai"	"Shanghai"
"dota_region_beijing"	"Beijing"
"dota_region_malaysia"	"Malaysia"
"dota_matchgroup_sa"	"South America"
"dota_matchgroup_eu"	"Europe West"
"DOTA_Hero_Selection_Timer_Second"	"GRAIN O' SAND"
"DOTA_Hero_Selection_Timer_Seconds"	"GRAINS O' SAND"
"DOTA_Hero_Selection_Search_Field_Default"	"SCOUR FER ADMIRALS"
"DOTA_Hero_Selection_Filter_All"	"ALL ADMIRALS"
"DOTA_Hero_Selection_AdvFilter_Carry"	"Carry"
"DOTA_Hero_Selection_AdvFilter_Initiator"	"Rumble Starter"
"DOTA_Hero_Selection_AdvFilter_Support"	"Support"
"DOTA_Hero_Selection_AdvFilter_Pusher"	"Pusher"
"DOTA_Hero_Selection_Team_Good"	"TH' RADIANT"
"DOTA_Hero_Selection_Team_Bad"	"TH' DIRE"
"DOTA_Hero_Selection_STR"	"MIGHT"
"DOTA_Hero_Selection_AGI"	"NIMBLENESS"
"DOTA_Hero_Selection_INT"	"WITS"
"DOTA_Hero_Selection_STR_Good"	"TH' RADIANT: MIGHT"
"DOTA_Hero_Selection_AGI_Good"	"NIMBLENESS"
"DOTA_Hero_Selection_INT_Good"	"WITS"
"DOTA_Hero_Selection_STR_Bad"	"TH' DIRE: MIGHT"
"DOTA_Hero_Selection_AGI_Bad"	"NIMBLENESS"
"DOTA_Hero_Selection_INT_Bad"	"WITS"
"DOTA_Hero_Selection_Confirm"	"Hire %s1"
"DOTA_Hero_Selection_Ban_Confirm"	"Exile %s1"
"DOTA_Hero_Selection_Pick_Confirm"	"Pick %s1"
"DOTA_Hero_Selection_Pick"	"SELECT PICK #%d"
"DOTA_Hero_Selection_Ban"	"SELECT EXILE #%d"
"DOTA_Hero_Selection_Complete"	"DONE"
"DOTA_Hero_Selection_Instruction"	"Ye've got %s1 t' pick an' admiral."
"DOTA_Hero_Selection_Instruction_Other"	"Other scallywags be pickin' their admirals."
"DOTA_Hero_Selection_Filter_Starter"	"ADVISED DECKHAND ADMIRALS"
"DOTA_ToolTip_Ability"	"SKILL:"
"DOTA_ToolTip_Ability_NoTarget"	"No Target"
"DOTA_ToolTip_Ability_Passive"	"Passive"
"DOTA_ToolTip_Ability_AutoCast"	"Auto-Cast"
"DOTA_ToolTip_Ability_Aura"	"Aura"
"DOTA_ToolTip_Ability_Toggle"	"Toggle"
"DOTA_ToolTip_Ability_Target"	"Unit Target"
"DOTA_ToolTip_Ability_Point"	"Point Target"
"DOTA_ToolTip_Targeting"	"AFFECTS:"
"DOTA_ToolTip_Targeting_Enemy"	"Foes"
"DOTA_ToolTip_Targeting_EnemyHero"	"Enemy Admirals"
"DOTA_ToolTip_Targeting_Self"	"Meself"
"DOTA_ToolTip_Targeting_Allies"	"Shipmates"
"DOTA_ToolTip_Targeting_Trees"	"Trees"
"DOTA_ToolTip_Level"	"RANK"
"DOTA_Hero_Tooltip_Level"	"Rank %s1"
"AbilityDuration"	"DURATION:"
"AbilityDamage"	"DAMAGE:"
"DOTA_Chat_Prompt"	"Shout:"
"dota_dashboard_players_online"	"%s1 SEAFARIN' SCALLYWAGS"
"dota_dashboard_welcome"	"AVAST YE, AN' WELCOME T' TH' DOTA NETWORK"
"dota_dashboard_actions"	"ACTIONS:"
"dota_dashboard_start_playing"	"PLUNDER"
"dota_dashboard_action_matchmaking"	"BRAWLFINDIN'"
"dota_dashboard_action_matchmaking_label"	"plunder wit' scallywags that can almost best ye"
"dota_dashboard_action_private"	"HIDDEN"
"dota_dashboard_action_private_label"	"plunder wit' some o' yer mateys"
"dota_dashboard_action_ai"	"A.I."
"dota_dashboard_action_ai_label"	"plunder wit' dummies"
"dota_dashboard_action_tutorial"	"TUTORIAL"
"dota_dashboard_action_tutorial_label"	"plunder wit' manual"
"dota_dashboard_action_friends_game_label"	"mateys currently in an battle lobby"
"dota_dashboard_prepareresearch"	"PREPARE/RESEARCH"
"dota_dashboard_helpout"	"LEND A HAND"
"dota_dashboard_action_mentor"	"MENTOR"
"dota_dashboard_action_mentor_label"	"recruit a deckhand, answer a query"
"dota_dashboard_action_contribute"	"CONTRIBUTE"
"dota_dashboard_action_contribute_label"	"scribble an admiral manual, rate a manual"
"dota_dashboard_start_learning"	"START LEARNIN':"
"dota_dashboard_heropedia"	"ADMIRALOGY"
"dota_dashboard_action_heroes"	"ADMIRALS"
"dota_dashboard_action_items"	"LOOT"
"dota_dashboard_action_replays"	"RECORDIN'S"
"dota_dashboard_action_comma"	", "
"dota_dashboard_tips"	"TIPS"
"dota_dashboard_configure"	"RIG:"
"dota_dashboard_settings"	"Riggings"
"dota_dashboard_quit"	"Abandon Ship"
"dota_dashboard_profile"	"YER LOG"
"dota_dashboard_chat"	"PARLEY"
"dota_dashboard_community"	"PARLEY"
"dota_dashboard_join_chat"	"BOARD CHANNEL"
"dota_dashboard_category_today"	"T'DAY"
"dota_dashboard_category_updates"	"AMENDMENTS"
"dota_dashboard_category_play"	"PLUNDER"
"dota_dashboard_category_watch"	"OBSERVE"
"dota_dashboard_category_socialize"	"CREW"
"dota_profile_mini_title"	"LOG"
"dota_profile_mini_party"	"PARTY"
"dota_profile_mini_2"	"RECENT ADMIRALS"
"matchmaking_status_title"	"Brawlfindin' State"
"matchmaking_status_text"	"Yer battle be ready"
"matchmaking_ready_text"	"%s1 Ready"
"matchmaking_player_afk"	"Scallywag ain't ready"
"matchmaking_player_cancel"	"Scallywag bail'd out"
"matchmaking_player_rematch"	"Scourin' fer new scallywags"
"dota_ready_fail_return"	"Seek out some other battle?"
"matchmaking_label"	"Brawlfindin'"
"matchmaking_wait_time"	"Time ye have t' wait: nnn"
"matchmaking_exp_geo"	"Scourin' outside yer area"
"matchmaking_exp_skill"	"Scourin' outside yer scallywag rank"
"matchmaking_region_active"	"PICKED"
"matchmaking_region_inactive"	"UNPICKED"
"matchmaking"	"ACTIVE SEAS"
"today_in_dota"	"T'DAY IN DOTA"
"matches_in_progress"	"TOP BATTLES UNDERWAY"
"findmatch"	"SEEK OUT A FIGHT"
"players_online"	"SEAFARIN' SCALLYWAGS"
"dota_profile_prestige"	"PRESTIGE"
"dota_profile_wins"	"VICTORIES:"
"dota_profile_losses"	"DEFEATS"
"dota_profile_leaves"	"ABANDONED"
"dota_join_chat_channel_prompt"	"Channel:"
"dota_join_chat_channel_button"	"BOARD"
"dota_join_chat_channel_name_header"	"Channel Title"
"dota_join_chat_channel_startup_header"	"Board On Startup"
"dota_chat_party_tab"	"Party"
"dota_chat_lobby_tab"	"Lobby"
"dota_game_lobby_title"	"BATTLE LOBBY"
"dota_match_history"	"BATTLE HISTORY"
"dota_match_history_details"	"BATTLE DETAILS"
"dota_match_history_win"	"VICTORY"
"dota_match_history_loss"	"DEFEAT"
"dota_match_history_back"	"SHUT"
"dota_match_history_Winner_GoodGuys"	"VICTOR: Th' Radiant"
"dota_match_history_Winner_BadGuys"	"VICTOR: Th' Dire"
"page_previous"	"PREVIOUS"
"page_next"	"NEXT"
"page_counter"	"Page: %s1"
"page_back"	"ASTERN"
"dota_load_game_title"	"FETCH BATTLE"
"dota_watch_replay"	"WATCH RECORDIN'"
"dota_download_replay"	"RECEIVE RECORDIN'"
"dota_replay_unavailable"	"RECORDIN' AIN'T AVAILABLE"
"dota_profile_show_match_history"	"BATTLE HISTORY"
"dota_persona_panel_title"	"SCALLYWAG DETAILS"
"dota_downloading_replay"	"Receivin'..."
"dota_num_players_searching"	"SCALLYWAGS SCOURIN': %s1"
"dota_search_range"	"SCOURIN' RANGE"
"dota_num_matching_players"	"MATCHIN' SCALLYWAGS: %s1 o' 10"
"dota_cancel_match_find"	"QUIT SCOURIN'"
"dota_reconnect_to_game"	"RE-DOCK"
"dota_disconnect_game"	"DEPART"
"dota_match_game_ui"	"Hidden Lobby Preparation"
"dota_number_of_spectators"	"Number o' Lookouts: %s1"
"dota_abandon_dialog_warning"	"Ditchin' an battle 'fore it's over wont make yer fellow scallywags like ye very much."
"dota_play_matchmaking"	"PLUNDER ADVENTURE"
"dota_play_practice"	"HIDDEN"
"dota_play_tournament"	"TOURNEY"
"dota_play_tutorial"	"TUTORIAL"
"dota_watch_game"	"OBSERVE"
"dota_play_matchmaking_desc"	"Find a brawl nearby wit' scallywags that be as tough as ye.
"
"dota_play_practice_desc"	"Arrange a hidden lobby t' go adventurin' with yer mateys or th' A.I. "
"dota_play_tutorial_desc"	"Plunder wit' a mentor or blast yer way through a lesson."
"dota_play_tournament_desc"	"Get int' a fight in a competitive tourney."
"dota_play_leaver_left_label"	"Arr, ye turned tail an' left th' battle. If it be an accident or some act o' mysterious, unseen forces, ye should rejoin th' battle. Leavin' yer crewmates will come back t' haunt ye if ye don't."
"dota_play_matchmaking_reconnect_hint"	"If some force beyond yer control made ye stop adventurin', ye can always hop back on board. Not doin' so would be seen as mutinous by yer fellow scallywags."
"dota_play_find_match"	"Seek a Battle"
"dota_play_welcome_title"	"Avast ye, an' welcome t' Dota 2"
"dota_play_welcome_text"	"Thanks fer participatin', yer feedback\nwill help use make sure Dota 2 ain't crap. "
"DOTA_create_private_lobby"	"Arr, scribble down a watchword t' craft a private battle (Dun 'ave t')"
"DOTA_join_private_title"	"JOIN HIDDEN BATTLE"
"DOTA_join_private_desc"	"What's th' watchword? Th' lobby-leader won't let ye onboard without it."
"DOTA_join_private_error1"	"That ain't th' watchword! Go away ye treacherous swine!"
"dota_apply"	"APPLY"
"DOTA_Matchmaking_NoRegion_Error"	"Pick out yer brawlfindin' region, landlubber!"
"DOTA_GameStartCountdown"	"Battle begins in %s1:%s2"
"DOTA_GameTime"	"%s1:%s2"
"DOTA_GamePreGame"	"Pre-Battle"
"find_match"	"Seek Out A Fight"
"play_tutorial"	"Plunder Tutorial"
"unlock_persona"	"Once yer at rank 2, ye'll get all sorts o' persona features"
"dota_party_leader"	"Party Leader"
"DOTA_UserMenu_Profile"	"See Dota Log"
"DOTA_UserMenu_SteamProfile"	"See Steam Log"
"DOTA_UserMenu_SendMessage"	"Cast Note..."
"DOTA_UserMenu_PartyKick"	"Boot from Party"
"DOTA_UserMenu_PartyInvite"	"Invite t' Party"
"DOTA_UserMenu_PartySuggestInvite"	"Suggest invite t' Party"
"DOTA_UserMenu_PartyLeave"	"Abandon Party"
"DOTA_UserMenu_Spectate"	"Observe Battle"
"DOTA_InvitedToParty"	"%s1 has invited ye t' a party."
"DOTA_Invite_Accept"	"AGREE"
"DOTA_Invite_Decline"	"DECLINE"
"DOTA_RP_INIT"	"Main Table"
"DOTA_RP_SPECTATING"	"Observin' A Battle"
"DOTA_ActivateGlyph"	"Activate Glyph"
"DOTA_PurchaseQuickbuy"	"Acquire Quickbuy"
"DOTA_PurchaseSticky"	"Acquire Sticky"
"DOTA_Pause"	"Halt"
"DOTA_Chat_Bot_RoamLane"	"Headin' back t' %s1"
"DOTA_Chat_CantPause"	"Ye can't halt."
"DOTA_Chat_NoPausesLeft"	"Ye've held us up long enough, ye can't halt th' battle anymore."
"DOTA_Chat_CantPauseYet"	"Ye cannot be haltin' th' battle fer %s1 seconds."
"DOTA_Chat_Paused"	"%s1 halted th' battle."
"DOTA_Chat_Unpaused"	"%s1 continued th' battle."
"DOTA_Chat_YouPaused"	"Ye halted th' battle, ye can only halt %s1 more times."
"DOTA_Chat_CantUnpauseTeam"	"Thar be no continuin' o' the battle on this crew yet."
"DOTA_Winner_GoodGuys"	"Radiant Victory"
"DOTA_Winner_BadGuys"	"Dire Victory"
"DOTA_Finish_Game"	"Wrap up Battle"
"DOTA_LearnAbilities"	"Attain Skills"
"DOTA_ReactiveHintTitle_TowerDamage"	"Damage from Crow's Nests"
"DOTA_ReactiveHintBody_TowerDamage"	"Crow nests do A LOT o' damage - if ye take even a handful of smacks from them ye might be needin' t' return t' th' fountain o' youth and heal up. It's better t' fight near th' crows nest only when yer creeps be attackin' it."
"DOTA_ReactiveHintTitle_Death"	"Watery Graves"
"DOTA_ReactiveHintBody_Death"	"When yer sent t' a watery grave ye'll rejoin yer crew back at yer fountain. The time t' come back gets higher as ye level so 'tis imperative that ye try t' NEVER PERISH. If yer low on health then return t' the fountain t' heal.
"
"DOTA_Tutorial_TaskCompleted"	"Finished!"
"DOTA_TutorialTitle_WelcomeToDota"	"Th' Basic Battle Concepts an' Controls Guide"
"DOTA_TutorialBody_WelcomeToDota"	"This guide be introducin' ye t' th' world o' Dota and show ye how t' be controllin' yer admiral."
"DOTA_TutorialTitle_MaidenIntro"	"Yer Admiral"
"DOTA_TutorialBody_MaidenIntro"	"Ye'll be plunderin' this match as Shadow Shaman, a master o' voodoo witchery. Ye're on Th' Radiant crew, th' blasted enemy crew be called Th' Dire."
"DOTA_TutorialTitle_MovingYourCharacter"	"Navigatin' yer Character"
"DOTA_TutorialBody_MovingYourCharacter"	"Ye can navigate yer character by jabbin' th' right mouse button where ye want to go. Yer crew fountain is directly below ye."
"DOTA_TutorialTask_MoveToFountain"	"Head towards yer fountain (right-jab)."
"DOTA_TutorialTitle_FountainIntro"	"Th' Fountain"
"DOTA_TutorialBody_FountainIntro"	"Th' fountain o' youth can quickly replenish ye life an' rum. It also rescues ye from Davy Jones' Locker if ye ever die. We be lookin' at sum' other important structures around now."
"DOTA_TutorialTitle_CameraIntro"	"Yer view"
"DOTA_TutorialBody_CameraIntro"	"Ye can scroll yer view by movin' th' mouse t' th' tip o' th' screen. Let's peek t' th' northeast at yer crew's Ancient."
"DOTA_TutorialTask_MoveToAncient"	"Move VIEW t' ancient (mouse th' screen tip)"
"DOTA_TutorialTitle_AncientIntro"	"Th' Ancient"
"DOTA_TutorialBody_AncientIntro"	"Th' Ancient be yer crew's most important contraption - if it's destroy'd then yer crew loses. Ye must destroy Th' Dire crew's Ancient t' be victorious."
"DOTA_TutorialTitle_ViewHeroIntro"	"Return t' yer Admiral"
"DOTA_TutorialBody_ViewHeroIntro"	"Ye can snap yer view back t' yer admiral by jabbin' yer portrait or double tappin' F1. Go on Cap'n, do that now t' return yer view t' yer admiral."
"DOTA_TutorialTask_ViewToHero"	"Move yer view back (jab yer portrait)"
"DOTA_TutorialTitle_MapIntro"	"Th' Mini-map"
"DOTA_TutorialBody_MapIntro"	"Thar be a mini-map on th' lower left corner o' yer screen. Yer stronghold (in green) be in th' bottom left corner an' th' enemy stronghold (in red) be in th' top right."
"DOTA_TutorialTitle_LaneIntro"	"Lanes o' Attack"
"DOTA_TutorialBody_LaneIntro"	"Thar be three main lanes towards yer rotten enemy's base. Let's move t' th' top one."
"DOTA_TutorialTask_MoveToTopLane"	"Order yer admiral to th' top lane.
"
"DOTA_TutorialTitle_BarracksIntro"	"Cabins"
"DOTA_TutorialBody_BarracksIntro"	"Each lane be havin' two cabins where yer crew's foot men, known as creeps, spawn at regular intervals. Creeps move towards yer foe's base an' attack yer foe's units an' buildings that be in thar path -- ye can't control them!"
"DOTA_TutorialTitle_LaningIntro"	"Th' war be startin'!"
"DOTA_TutorialBody_LaningIntro"	"A wave o' Radiant creeps is about t' spawn. Follow them int' combat t' provide ranged support. Try not t' get hit - ye be too important t' be takin' damage! When a wave o' creeps dies, it's best t' be backin' off t' regroup with th' next creep wave."
"DOTA_TutorialTitle_FindingYourHero"	"Locatin' Yer Admiral"
"DOTA_TutorialBody_FindingYourHero"	"If ye lose track o' yer admiral, ye can double-tap F1 or jab on yer admiral's portrait t' center th' spyglass on it."
"DOTA_TutorialTask_FollowCreeps"	"Follow yer creeps towards th' front line."
"DOTA_TutorialTitle_CombatIntro"	"War"
"DOTA_TutorialBody_CombatIntro"	"Thar be some combat up ahead. Remember t' be careful an' avoid gettin' hurt."
"DOTA_TutorialTitle_AttackingIntro"	"Attackin'"
"DOTA_TutorialBody_AttackingIntro"	"Ye can attack foes by right-jabbin' 'em (ye only need t' right-jab 'em once)."
"DOTA_TutorialTitle_BountiesIntro"	"Bounties"
"DOTA_TutorialBody_BountiesIntro"	"When ye get th' final blow on a unit or contraption ye get a bounty. Attack foes that're low on life an' try t' get th' bounty."
"DOTA_TutorialTask_LastHitCreeps"	"Earn bounties from killin' blows %s1/%s2"
"DOTA_TutorialTitle_SpendGold"	"Spendin' Yer Coins"
"DOTA_TutorialBody_SpendGold"	"Let's head back t' yer stronghold an' spend yer hard-earned coins. Right-jab on yer crew's stronghold in th' bottom left o' th' mini-map t' be headin' there."
"DOTA_TutorialTask_ReturnToShop"	"Head back t' yer stronghold t' shop"
"DOTA_TutorialTitle_BuyFromShop"	"Spendin' Coins: th' Market"
"DOTA_TutorialBody_BuyFromShop"	"Ye can use th' coins ye earn t' buy loot from th' market."
"DOTA_TutorialTitle_BuyFromShop2"	"Buyin' From th' Market"
"DOTA_TutorialBody_BuyFromShop2"	"Left-click on th' shop t' be viewin' th' loot that be fer sale. Double-click on th' town portal scroll and th' Blades of Attack t' be buyin' them."
"DOTA_TutorialTitle_CloseShop"	"Closin' th' Market"
"DOTA_TutorialBody_CloseShop"	"T' close th' market, ye can left-click th' X mark at th' top left, left-click anywhere outside th' market menu or be pressin' th' button near yer inventory. Th' market also automatically closes when ye walk out o' its purchase zone."
"DOTA_TutorialTask_BuyTPScroll"	"Buy two pieces o' loot from th' market."
"DOTA_TutorialTitle_TeleportIntro"	"Types o' Loot"
"DOTA_TutorialBody_TeleportIntro"	"Yer Blades o' Attack give off a passive damage bonus, whereas th' Town Porthole Scroll must be activated. Usin' a Town Porthole Scroll allows ye t' teleport t' any o' yer team's contraptions. This be critical t' save a good deal o' time."
"DOTA_TutorialTitle_UseItemIntro"	"Usin' th' Town Portal Scroll t' Teleport"
"DOTA_TutorialBody_UseItemIntro"	"T' use th' Town Portal Scroll, left-jab it then left-jab fer yer desired destination in th' mini-map. Teleport be a channelin' spell, so ye'd best be careful not t' interrupt it by givin' yer admiral some other command whilst ye cast it."
"DOTA_TutorialTask_UseTPScroll"	"Use yer Town Portal Scroll t' teleport."
"DOTA_TutorialTitle_StayInLane"	"Stayin' in Lane"
"DOTA_TutorialBody_StayInLane"	"Since ye earn experience an' coins from defeatin' foes 'tis important t' spend time in th' lane at th' beginnin' o' th' battle. Return t' yer lane t' get back int' combat."
"DOTA_TutorialTask_BackToCombat"	"Get back t' yer lane."
"DOTA_TutorialTitle_ExpIntro"	"Gainin' Experience"
"DOTA_TutorialBody_ExpIntro"	"When a foe perishes all nearby admirals on yer crew share th' experience. Try t' get enough experience t' gain a rank."
"DOTA_TutorialTask_GetALevel"	"Gain a rank by givin' yer crewmates a hand in killin' th' enemies who be a-comin'."
"DOTA_TutorialTitle_LevelIntro"	"Gainin' Ranks"
"DOTA_TutorialBody_LevelIntro"	"When ye earn a rank ye also be earnin' a tally t' spend on a skill."
"DOTA_TutorialTitle_AbilityIntro"	"Spendin' Skill Points"
"DOTA_TutorialBody_AbilityIntro"	"Ye can see what each skill can do by hoverin' th' mouse over its icon. Spend tallies t' earn ranks in skills by jabbin' on th' yellow bar beneath their icon. Rank up yer Ether Shock skill."
"DOTA_TutorialTask_BuyAbility"	"Spend a skill point t' be learnin' Ether Shock."
"DOTA_TutorialTitle_CastIntro"	"Usin' Skills"
"DOTA_TutorialBody_CastIntro"	"Th' Ether Shock ability does magical damage. It costs ye rum every time ye use it. Jab th' ability icon then left-jab where ye'd like to cast it."
"DOTA_TutorialTask_CastSpell"	"Use yer Ether Shock skill."
"DOTA_TutorialTitle_RazorIntro"	"Razor"
"DOTA_TutorialBody_RazorIntro"	"Th' scurvy dog's admiral Razor has joined th' battle for th' Dire crew. He be a master o' lightnin' witchery an' has th' awe inspirin' Plasma Field skill. He'll be goin' t' attack along th' top lane."
"DOTA_TutorialTitle_NewItems"	"New Loot"
"DOTA_TutorialBody_NewItems"	"Ye've earned a few pieces o' loot t' help ye in battle. Ye've tangos with an ABILITY t' eat a tree t' gain life. Ye also have a sense o' stubbornness that PASSIVELY increases yer regeneration."
"DOTA_TutorialTitle_AttackTower"	"Attackin' Crow's Nests"
"DOTA_TutorialBody_AttackTower"	"Crow nests have powerful attacks and a lot o' hitpoints. Attack with yer creeps and try t' destroy th' crow nest t' finish this tutorial! Retreat if yer creeps die and try t' keep yer health up!"
"DOTA_TutorialTask_KillTower"	"Destroy yer foe's crow's nest."
"DOTA_TutorialTitle_WinningIntro"	"Ye Be Victorious!"
"DOTA_TutorialBody_WinningIntro"	"Yo ho! Ye earn'd yer sea legs by completin' th' Basic Battle Concepts an' Controls guide, mate! Th' next guide'll run ye through a full battle - ye even get t' pick yer admiral!"
"DOTA_TutorialTitle_ChooseYourHero"	"Pickin' yer admiral"
"DOTA_TutorialBody_ChooseYourHero"	"Shadow Shaman be a fine admiral to find yer sea legs with. He has a ranged attack so ye can attack from th' edge of a battle with comfort. His Serpent Wards skill 'tis especially good for destroyin' crow's nests. Ye can complete this tutorial with any admiral, though."
"DOTA_TutorialTitle_PrepareForBattle"	"Preparin' fer a Fight"
"DOTA_TutorialBody_PrepareForBattle"	"When ye spawn int' a battle ye got one skill tally an' 603 coins t' acquire loot. Spend th' tally t' learn a skill. For this lesson we've enable'd auto-acquire so ye don't need t' worry about th' market, lassy."
"DOTA_TutorialTitle_AutoBuyIntro"	"Auto-Acquire"
"DOTA_TutorialBody_AutoBuyIntro"	"Auto-buy will aquire th' right items fer yer character. Ye will auto pick up yer loot when ye return t' th' fountain. If ye receive a note tellin' ye t' head t' th' black market, check th' minimap fer th' location. Head out once yer ready."
"DOTA_TutorialTask_MoveWhenReady"	"Move out when yer ready."
"DOTA_TutorialTitle_SpawningBots"	"Shipmates an' Enemies"
"DOTA_TutorialBody_SpawningBots"	"Fer this lesson ye be playin' against two computer-controlled landlubbers an' ye will be havin' one computer player on yer crew. Try t' push on th' yardarm lane t' th' Dire base an' kill the'r Ancient."
"DOTA_TutorialTask_DefeatAncient"	"Defeat th' Dire crew's Ancient."
"DOTA_TutorialTitle_DefeatEnemyAncient"	"Strikin' th' Foe"
"DOTA_TutorialBody_DefeatEnemyAncient"	"Th' enemy defenses be strong an' ye will need t' attack wi' multiple waves o' creeps t' brin' down each tower. Return t' yer ship when yer health be low or when ye wish t' buy new items."
"DOTA_TutorialTitle_Train_Pudge"	"Pudge Trainin'"
"DOTA_TutorialBody_Train_Pudge"	"Learn t' play Pudge, matey. Be killin' some bots in th' bottom lane."
"DOTA_TutorialTitle_Pudge_Goal"	"Murder some admirals!"
"DOTA_TutorialBody_Pudge_Goal"	"Gank th' ye foes two admirals in th' bottom lane. Try t' gain 5 admiral kills without dyin' more than 3 times."
"DOTA_TutorialTitle_LastHit"	"Last Hit / Deny Practice"
"DOTA_TutorialBody_LastHit"	"Try t' be gettin' as many last hits an' denies as ye can wthin th' time limit. Yer tally be a combo o' last hits, denies, an' 'ow much damage ye take."
"DOTA_TutorialTitle_RoundOne"	"Round One - Sniper"
"DOTA_TutorialTitle_RoundTwo"	"Round Two - Anti-Mage"
"DOTA_TutorialTitle_RoundThree"	"Round Three - Mirana"
"DOTA_TutorialTitle_RoundFour"	"Round Four - Crystal Maiden"
"DOTA_TutorialTitle_RoundFive"	"Round Five - Shadow Fiend"
"npc_dota_hero_queenofpain"	"Queen o' Pain"
"npc_dota_hero_antimage"	"Anti-Mage"
"npc_dota_hero_kunkka"	"Kunkka"
"npc_dota_hero_lina"	"Lina"
"npc_dota_hero_mirana"	"Mirana"
"npc_dota_hero_windrunner"	"Windranger"
"npc_dota_hero_slardar"	"Slardar"
"npc_dota_hero_lion"	"Lion"
"npc_dota_hero_phantom_assassin"	"Phantom Assassin"
"npc_dota_hero_tidehunter"	"Tidehunter"
"npc_dota_hero_witch_doctor"	"Witch Doctor"
"npc_dota_hero_vengefulspirit"	"Vengeful Spirit"
"npc_dota_hero_juggernaut"	"Juggernaut"
"npc_dota_hero_earthshaker"	"Earthshaker"
"npc_dota_hero_pudge"	"Pudge"
"npc_dota_hero_bane"	"Bane"
"npc_dota_hero_crystal_maiden"	"Crystal Maiden"
"npc_dota_hero_sven"	"Sven"
"npc_dota_hero_skeleton_king"	"Wraith King"
"npc_dota_hero_storm_spirit"	"Storm Spirit"
"npc_dota_hero_sand_king"	"Sand King"
"npc_dota_hero_nevermore"	"Shadow Fiend"
"npc_dota_hero_drow_ranger"	"Drow Ranger"
"npc_dota_hero_axe"	"Axe"
"npc_dota_hero_bloodseeker"	"Bloodseeker"
"npc_dota_hero_phantom_lancer"	"Phantom Lancer"
"npc_dota_hero_razor"	"Razor"
"npc_dota_hero_morphling"	"Morphling"
"npc_dota_hero_zuus"	"Zeus"
"npc_dota_hero_tiny"	"Tiny"
"npc_dota_hero_puck"	"Puck"
"npc_dota_hero_lich"	"Lich"
"npc_dota_hero_shadow_shaman"	"Shadow Shaman"
"npc_dota_hero_riki"	"Riki"
"npc_dota_hero_enigma"	"Enigma"
"npc_dota_hero_tinker"	"Tinker"
"npc_dota_hero_sniper"	"Sniper"
"npc_dota_hero_necrolyte"	"Necrophos"
"npc_dota_hero_warlock"	"Warlord"
"npc_dota_hero_beastmaster"	"Beastmaster"
"npc_dota_hero_venomancer"	"Venomancer"
"npc_dota_hero_faceless_void"	"Faceless Void"
"npc_dota_hero_death_prophet"	"Death Prophet"
"npc_dota_hero_pugna"	"Pugna"
"npc_dota_hero_templar_assassin"	"Templar Assassin"
"npc_dota_hero_viper"	"Viper"
"npc_dota_hero_luna"	"Luna"
"npc_dota_hero_dragon_knight"	"Dragon Knight"
"npc_dota_hero_dazzle"	"Dazzle"
"npc_dota_hero_rattletrap"	"Clockwerk"
"npc_dota_hero_leshrac"	"Leshrac"
"npc_dota_hero_furion"	"Nature's Prophet"
"npc_dota_hero_life_stealer"	"Lifestealer"
"npc_dota_hero_dark_seer"	"Dark Seer"
"npc_dota_hero_clinkz"	"Clinkz"
"npc_dota_hero_omniknight"	"Omniknight"
"npc_dota_hero_enchantress"	"Enchantress"
"npc_dota_hero_huskar"	"Huskar"
"npc_dota_hero_night_stalker"	"Night Stalker"
"npc_dota_hero_broodmother"	"Broodmother"
"npc_dota_hero_bounty_hunter"	"Bounty Hunter"
"npc_dota_hero_weaver"	"Weaver"
"npc_dota_hero_jakiro"	"Jakiro"
"npc_dota_hero_batrider"	"Batrider"
"npc_dota_hero_chen"	"Chen"
"npc_dota_hero_spectre"	"Spectre"
"npc_dota_hero_doom_bringer"	"Doom"
"npc_dota_hero_ancient_apparition"	"Ancient Apparition"
"npc_dota_hero_ursa"	"Ursa"
"npc_dota_hero_spirit_breaker"	"Spirit Breaker"
"npc_dota_hero_gyrocopter"	"Gyrocopter"
"npc_dota_hero_alchemist"	"Alchemist"
"npc_dota_hero_invoker"	"Invoker"
"npc_dota_hero_silencer"	"Silencer"
"random"	"Take a chance"
"dota_fountain"	"Fountain"
"npc_dota_creep"	"Creep"
"npc_dota_creep_lane"	"Lane Creep"
"npc_dota_creep_siege"	"Siege Engine"
"npc_dota_tower"	"Crow's Nest"
"npc_dota_barracks"	"Cabins"
"npc_dota_fort"	"Th' Old Pirate Ship"
"npc_dota_roshan"	"Th' Kraken"
"npc_dota_shadow_shaman_ward_1"	"Serpent Ward"
"npc_dota_shadow_shaman_ward_2"	"Serpent Ward"
"npc_dota_shadow_shaman_ward_3"	"Serpent Ward"
"npc_dota_necronomicon_warrior_1"	"Necronomicon Warrior"
"npc_dota_necronomicon_warrior_2"	"Necronomicon Warrior"
"npc_dota_necronomicon_warrior_3"	"Necronomicon Warrior"
"npc_dota_necronomicon_archer_1"	"Necronomicon Bowman"
"npc_dota_necronomicon_archer_2"	"Necronomicon Bowman"
"npc_dota_necronomicon_archer_3"	"Necronomicon Bowman"
"npc_dota_scout_hawk"	"Scout Hawk"
"npc_dota_greater_hawk"	"Greater Hawk"
"npc_dota_beastmaster_boar"	"Boar"
"npc_dota_beastmaster_greater_boar"	"Greater Boar"
"npc_dota_courier"	"Courier"
"npc_dota_flying_courier"	"Flyin' Courier"
"npc_dota_furion_treant"	"Treant"
"npc_dota_invoker_forged_spirit"	"Forged Ghost"
"npc_dota_dark_troll_warlord_skeleton_warrior"	"Skeleton Warrior"
"npc_dota_enraged_wildkin_tornado"	"Tornado"
"npc_dota_warlock_golem_1"	"Warlock Golem"
"npc_dota_warlock_golem_2"	"Warlock Golem"
"npc_dota_warlock_golem_3"	"Warlock Golem"
"npc_dota_warlock_golem_scepter_1"	"Warlock Golem"
"npc_dota_warlock_golem_scepter_2"	"Warlock Golem"
"npc_dota_warlock_golem_scepter_3"	"Warlock Golem"
"npc_dota_broodmother_spiderling"	"Spiderlin'"
"npc_dota_broodmother_spiderite"	"Spiderite"
"npc_dota_witch_doctor_death_ward"	"Death Ward"
"npc_dota_venomancer_plague_ward_1"	"Black Death"
"npc_dota_venomancer_plague_ward_2"	"Black Death"
"npc_dota_venomancer_plague_ward_3"	"Black Death"
"npc_dota_venomancer_plague_ward_4"	"Black Death"
"npc_dota_lesser_eidolon"	"Lesser Eidolon"
"npc_dota_eidolon"	"Eidolon"
"npc_dota_greater_eidolon"	"Greater Eidolon"
"npc_dota_dire_eidolon"	"Privateer Eidolon"
"npc_dota_rattletrap_cog"	"Power Cog"
"npc_dota_juggernaut_healing_ward"	"Healin' Ward"
"npc_dota_templar_assassin_psionic_trap"	"Psionic Trap"
"npc_dota_weaver_swarm"	"Beetle"
"npc_dota_pugna_nether_ward_1"	"Nether Ward"
"npc_dota_pugna_nether_ward_2"	"Nether Ward"
"npc_dota_pugna_nether_ward_3"	"Nether Ward"
"npc_dota_pugna_nether_ward_4"	"Nether Ward"
"npc_dota_observer_wards"	"Wayfarer Ward"
"npc_dota_sentry_wards"	"Sentry Ward"
"dota_unkown"	"Ain't Known"
"npc_dota_creep_badguys_melee"	"Close Combat Creep"
"npc_dota_creep_badguys_melee_upgraded_mega"	"Mega Close Combat Creep"
"npc_dota_creep_badguys_ranged"	"Ranged Creep"
"npc_dota_creep_badguys_ranged_upgraded_mega"	"Mega Ranged Creep"
"npc_dota_badguys_siege"	"Siege Creep"
"npc_dota_creep_goodguys_melee"	"Close Combat Creep"
"npc_dota_creep_goodguys_melee_upgraded_mega"	"Mega Close Combat Creep"
"npc_dota_creep_goodguys_ranged"	"Ranged Creep"
"npc_dota_creep_goodguys_ranged_upgraded_mega"	"Mega Ranged Creep"
"npc_dota_goodguys_siege"	"Siege Creep"
"npc_dota_neutral_kobold"	"Kobold"
"npc_dota_neutral_kobold_tunneler"	"Kobold Soldier"
"npc_dota_neutral_kobold_taskmaster"	"Kobold Foreman"
"npc_dota_neutral_centaur_outrunner"	"Centaur Courser"
"npc_dota_neutral_centaur_khan"	"Centaur Conqueror"
"npc_dota_neutral_fel_beast"	"Fell Spirit"
"npc_dota_neutral_polar_furbolg_champion"	"Hellbear"
"npc_dota_neutral_polar_furbolg_ursa_warrior"	"Hellbear Smasher"
"npc_dota_neutral_mud_golem"	"Mud Golem"
"npc_dota_neutral_ogre_mauler"	"Ogre Bruiser"
"npc_dota_neutral_ogre_magi"	"Ogre Frostmage"
"npc_dota_neutral_giant_wolf"	"Giant Wolf"
"npc_dota_neutral_alpha_wolf"	"Alpha Wolf"
"npc_dota_neutral_wildkin"	"Wildwing"
"npc_dota_neutral_enraged_wildkin"	"Wildwing Ripper"
"npc_dota_neutral_satyr_soulstealer"	"Satyr Mindstealer"
"npc_dota_neutral_satyr_hellcaller"	"Satyr Tormenter"
"npc_dota_neutral_satyr_trickster"	"Satyr Banisher"
"npc_dota_neutral_jungle_stalker"	"Ancient Stalker"
"npc_dota_neutral_elder_jungle_stalker"	"Ancient Primal Stalker"
"npc_dota_neutral_rock_golem"	"Ol' Rock Golem"
"npc_dota_neutral_granite_golem"	"Ol' Granite Golem"
"npc_dota_neutral_big_thunder_lizard"	"Ancient Thunderhide"
"npc_dota_neutral_small_thunder_lizard"	"Ancient Rumblehide"
"npc_dota_neutral_black_drake"	"Ancient Black Drake"
"npc_dota_neutral_black_dragon"	"Ol' Black Dragon"
"npc_dota_neutral_gnoll_assassin"	"Vhoul Assassin"
"npc_dota_neutral_ghost"	"Ghost"
"npc_dota_neutral_dark_troll"	"Hill Troll"
"npc_dota_neutral_dark_troll_warlord"	"Dark Troll Summoner"
"npc_dota_neutral_forest_troll_berserker"	"Hill Troll Berserker"
"npc_dota_neutral_forest_troll_high_priest"	"Hill Troll Priest"
"npc_dota_neutral_harpy_scout"	"Harpy Scout"
"npc_dota_neutral_harpy_storm"	"Harpy Stormcrafter"
"npc_dota_goodguys_tower1_top"	"Crow's Nest"
"npc_dota_goodguys_tower1_mid"	"Crow's Nest"
"npc_dota_goodguys_tower1_bot"	"Crow's Nest"
"npc_dota_goodguys_tower2_top"	"Crow's Nest"
"npc_dota_goodguys_tower2_mid"	"Crow's Nest"
"npc_dota_goodguys_tower2_bot"	"Crow's Nest"
"npc_dota_goodguys_tower3_top"	"Crow's Nest"
"npc_dota_goodguys_tower3_mid"	"Crow's Nest"
"npc_dota_goodguys_tower3_bot"	"Crow's Nest"
"npc_dota_goodguys_tower4"	"Crow's Nest"
"npc_dota_badguys_tower1_top"	"Crow's Nest"
"npc_dota_badguys_tower1_mid"	"Crow's Nest"
"npc_dota_badguys_tower1_bot"	"Crow's Nest"
"npc_dota_badguys_tower2_top"	"Crow's Nest"
"npc_dota_badguys_tower2_mid"	"Crow's Nest"
"npc_dota_badguys_tower2_bot"	"Crow's Nest"
"npc_dota_badguys_tower3_top"	"Crow's Nest"
"npc_dota_badguys_tower3_mid"	"Crow's Nest"
"npc_dota_badguys_tower3_bot"	"Crow's Nest"
"npc_dota_badguys_tower4"	"Crow's Nest"
"npc_dota_goodguys_melee_rax_top"	"Close Combat Cabins"
"npc_dota_goodguys_melee_rax_mid"	"Close Combat Cabins"
"npc_dota_goodguys_melee_rax_bot"	"Close Combat Cabins"
"npc_dota_badguys_melee_rax_top"	"Close Combat Cabins"
"npc_dota_badguys_melee_rax_mid"	"Close Combat Cabins"
"npc_dota_badguys_melee_rax_bot"	"Close Combat Cabins"
"npc_dota_goodguys_range_rax_top"	"Close Combat Cabins"
"npc_dota_goodguys_range_rax_mid"	"Close Combat Cabins"
"npc_dota_goodguys_range_rax_bot"	"Close Combat Cabins"
"npc_dota_badguys_range_rax_top"	"Ranged Cabins"
"npc_dota_badguys_range_rax_mid"	"Ranged Cabins"
"npc_dota_badguys_range_rax_bot"	"Ranged Cabins"
"npc_dota_goodguys_fort"	"Radiant's Ancient"
"npc_dota_badguys_fort"	"Dire's Ancient"
"npc_dota_goodguys_fillers"	"Contraption"
"npc_dota_badguys_fillers"	"Contraption"
"DOTA_Shop_Category_0_Hotkey"	"CONSUMABLES (%s1)"
"DOTA_Shop_Category_1_Hotkey"	"ATTRIBUTES (%s1)"
"DOTA_Shop_Category_2_Hotkey"	"ARMAMENTS (%s1)"
"DOTA_Shop_Category_3_Hotkey"	"ARCANE (%s1)"
"DOTA_Shop_Category_4_Hotkey"	"COMMON (%s1)"
"DOTA_Shop_Category_5_Hotkey"	"SUPPORT (%s1)"
"DOTA_Shop_Category_6_Hotkey"	"CASTER (%s1)"
"DOTA_Shop_Category_7_Hotkey"	"WEAPONRY (%s1)"
"DOTA_Shop_Category_8_Hotkey"	"ARMOR (%s1)"
"DOTA_Shop_Category_9_Hotkey"	"RELICS (%s1)"
"DOTA_Shop_Category_10_Hotkey"	"PAGE 1 (%s1)"
"DOTA_Shop_Category_11_Hotkey"	"PAGE 2 (%s1)"
"DOTA_Shop_Category_12_Hotkey"	"BLACK MARKET (%s1)"
"DOTA_Shop_Category_0"	"CONSUMABLES"
"DOTA_Shop_Category_1"	"ATTRIBUTES"
"DOTA_Shop_Category_2"	"ARMAMENTS"
"DOTA_Shop_Category_3"	"ARCANE"
"DOTA_Shop_Category_4"	"COMMON"
"DOTA_Shop_Category_5"	"SUPPORT"
"DOTA_Shop_Category_6"	"CASTER"
"DOTA_Shop_Category_7"	"WEAPONRY"
"DOTA_Shop_Category_8"	"ARMOR"
"DOTA_Shop_Category_9"	"RELICS"
"DOTA_Shop_Category_10"	"PAGE 1"
"DOTA_Shop_Category_11"	"PAGE 2"
"DOTA_Shop_Category_12"	"BLACK MARKET"
"DOTA_SHOP_CATEGORY_CONSUMABLES"	"Consumables"
"DOTA_SHOP_CATEGORY_ATTACK"	"Attack"
"DOTA_SHOP_CATEGORY_DEFENSE"	"Defense"
"DOTA_SHOP_CATEGORY_ABILITIES"	"Abilities"
"DOTA_SHOP_CATEGORY_MOVEMENT"	"Movement"
"DOTA_SHOP_CATEGORY_ATTRIBUTES"	"Attributes"
"DOTA_SHOP_CATEGORY_UNIQUES"	"Uniques"
"DOTA_SHOP_FILTERS"	"FILTERS"
"DOTA_SHOP_FILTER_BY"	"FILTER BY:"
"DOTA_SHOP_ITEMS"	"LOOT"
"DOTA_SHOP_CLOSE"	"X SHUT"
"DOTA_SHOP_DETAILS_ADD_TO_QUICK"	"ADD T' QUICK BUY"
"DOTA_SHOP_DETAILS_UPGRADE"	"UPGRADE LOOT"
"DOTA_SHOP_DETAILS_PURCHASE"	"ACQUIRE LOOT"
"DOTA_SHOP_DETAILS_COMPLETE"	"FINISH"
"DOTA_SHOP_QUICK_BUY"	"QUICK BUY:"
"DOTA_SHOP_STASH"	"LOOT IN STASH:"
"DOTA_Shop_Search_Results_Partial"	"'%s1' o' '%s2' pieces o' loot that be matchin' yer search:"
"DOTA_Shop_Search_Results"	"Pieces o' loot that be matchin' yer scour:"
"DOTA_SHOP_TAG_ALL"	"ALL"
"DOTA_SHOP_TAG_CONSUMABLE"	"Consumable"
"DOTA_SHOP_TAG_DAMAGE"	"Damage"
"DOTA_SHOP_TAG_ATTACK_SPEED"	"Attack Speed"
"DOTA_SHOP_TAG_CRIT_CHANCE"	"Critical Chance"
"DOTA_SHOP_TAG_ARMOR"	"Armor"
"DOTA_SHOP_TAG_EVASION"	"Dodge"
"DOTA_SHOP_TAG_MOVE_SPEED"	"Movement Speed"
"DOTA_SHOP_TAG_TELEPORT"	"Teleport"
"DOTA_SHOP_TAG_SEE_INVIS"	"See th' unseen"
"DOTA_SHOP_TAG_COURIER"	"Courier"
"DOTA_SHOP_TAG_STR"	"Might"
"DOTA_SHOP_TAG_INT"	"Wits"
"DOTA_SHOP_TAG_AGI"	"Nimbleness"
"DOTA_SHOP_TAG_REGEN_HEALTH"	"Life Refill"
"DOTA_SHOP_TAG_REGEN_MANA"	"Rum Refill"
"DOTA_SHOP_TAG_BLOCK"	"Block Damage"
"DOTA_SHOP_TAG_LIFESTEAL"	"Lifesteal"
"DOTA_SHOP_TAG_BOOST_HEALTH"	"Increase Life"
"DOTA_SHOP_TAG_BOOST_MANA"	"Boost Rum"
"DOTA_SHOP_TAG_BOOST_ARMOR"	"Temper Armor"
"DOTA_SHOP_TAG_MANA_POOL"	"Rum Pool"
"DOTA_SHOP_TAG_HEALTH_POOL"	"Life Pool"
"DOTA_SHOP_TAG_HARD_TO_TAG"	"Hard pieces o' loot t' categorize"
"DOTA_SHOP_TAG_UNIQUE"	"Unique"
"DOTA_SHOP_TAG_TUTORIAL"	"Guide"
"DOTA_Item_Build_Test_Title"	"Try Out Loot Build"
"DOTA_Item_Build_Starting_Items"	"Startin' Loot"
"DOTA_Item_Build_Early_Game"	"Early Venturin'"
"DOTA_Item_Build_Core_Items"	"Core Loot"
"DOTA_Item_Build_Luxury"	"Situational Loot"
"DOTA_GOLD"	"Coin"
"DOTA_XP"	"XP"
"DOTA_EXCLAMATION"	"!"
"DOTA_PLUS"	"+"
"DOTA_DAMAGE"	"DAMAGE"
"DOTA_BONUS"	"+%s1"
"DOTA_PENALTY"	"-%s1"
"DOTA_MISS"	"Miss!"
"DOTA_EVADE"	"Dodge!"
"DOTA_Inventory"	"Chest"
"DOTA_InventoryOverflow"	"Overflow"
"DOTA_InventoryOverflowMsg"	"Loot t' be left in th' overflow will return t' th' stash."
"DOTA_InventoryStash"	"STASH"
"DOTA_InventoryQuickBuy"	"QUICK BUY"
"DOTA_Inventory_ReliableGold"	"Reliable Coin: %s1"
"DOTA_Inventory_UnreliableGold"	"Unreliable Coin: %s1"
"DOTA_Inventory_Item_Owned_By"	"Property O': %s1"
"DOTA_InventoryMenu_Sell"	"Sell"
"DOTA_InventoryMenu_Disassemble"	"Dismantle"
"DOTA_InventoryMenu_ShowInShop"	"See in Market"
"DOTA_InventoryMenu_DropFromStash"	"Drop from Stash"
"DOTA_Scoreboard_GoodGuys"	"TH' RADIANT"
"DOTA_Scoreboard_BadGuys"	"TH' DIRE"
"DOTA_Scoreboard_Header_PLAYER"	"SCALLYWAG"
"DOTA_Scoreboard_Header_KDA"	"M / WG / A"
"DOTA_Scoreboard_Header_Level"	"RANK"
"DOTA_Scoreboard_Header_Gold"	"COIN"
"DOTA_Scoreboard_Team_Scores_Header"	"MURDERS PER CREW"
"DOTA_Scoreboard_Heroes_Killed"	"ADMIRALS"
"DOTA_Scoreboard_Towers_Killed"	"CROW'S NESTS"
"DOTA_Scoreboard_Barracks_Killed"	"CABINS"
"DOTA_Scoreboard_Level_Hero"	"Rank %s1 %s2"
"DOTA_Scoreboard_Picking_Hero"	"Pickin' an Admiral"
"DOTA_Scoreboard_Disconnected"	"Departed"
"DOTA_Tooltip_Ability_Next_Upgrade_Level"	"Next Upgrade at Admiral Rank %s1"
"DOTA_Tooltip_Ability_Upgradable"	"Upgradable"
"DOTA_Lobby_Starting_Team"	"STARTIN' CREW"
"DOTA_Starting_Team_Random"	"Take a chance"
"DOTA_Starting_Team_Radiant"	"Radiant"
"DOTA_Starting_Team_Dire"	"Dire"
"Dota_Lobby_Set_Password"	"APPLY"
"DOTA_Tip_Temp1"	"This be th' first sample tip"
"DOTA_Tip_Temp2"	"This be th' second sample tip"
"DOTA_Tip_Temp3"	"This be th' third sample tip"
"dota_hud_error_ability_not_learned"	"Skill Ain't Learned"
"dota_hud_error_not_enough_mana"	"Ain't Enough Rum"
"dota_hud_error_ability_in_cooldown"	"Rechargin'..."
"dota_hud_error_item_in_cooldown"	"Rechargin'..."
"dota_hud_error_no_target"	"No Target"
"dota_hud_error_cant_cast_on_hero"	"Skill Can't Target Admirals"
"dota_hud_error_cant_cast_on_creep"	"Skill Can't Target Creeps"
"dota_hud_error_cant_cast_on_mechanical"	"Skill Can't Target Mechanical Units"
"dota_hud_error_cant_cast_on_building"	"Skill Can't Target Buildin's"
"dota_hud_error_cant_cast_on_courier"	"Skill Can't Target Couriers"
"dota_hud_error_cant_cast_on_other"	"Skill Can't Target That"
"dota_hud_error_cant_cast_on_self"	"Skill Can't Target Yer Self"
"dota_hud_error_cant_cast_on_ally"	"Skill Can't Target Shipmates"
"dota_hud_error_cant_cast_on_enemy"	"Skill Can't Target Enemies"
"dota_hud_error_cant_target_shop"	"Can't Target Market"
"dota_hud_error_cant_target_rune"	"Can't Target Rune"
"dota_hud_error_cant_target_item"	"Ye Can't Target This Loot"
"dota_hud_error_cant_cast_on_ancient"	"Skill Can't Target Ancients"
"dota_hud_error_cant_cast_on_own_illusion"	"Skill Can't Target Own Mirage"
"dota_hud_error_cant_cast_on_summoned"	"Skill Can't Target Conjured Units"
"dota_hud_error_cant_cast_on_dominated"	"Skill Can't Target Dominated Units"
"dota_hud_error_cant_cast_enemy_hero"	"Skill Can't Target Enemy Admirals"
"dota_hud_error_cant_cast_creep_level"	"Skill Can't Target Creeps o' This Rank"
"dota_hud_error_target_magic_immune"	"Target Immune To Witchcraft"
"dota_hud_error_target_attack_immune"	"Target Can't Be Attacked"
"dota_hud_error_target_cant_be_denied"	"Target Can't Be Denied"
"dota_hud_error_unit_silenced"	"Muted"
"dota_hud_error_unit_muted"	"Gagged"
"dota_hud_error_unit_command_restricted"	"Can't Act"
"dota_hud_error_unit_disarmed"	"Can't Attack"
"dota_hud_error_target_invulnerable"	"Target Unkillable"
"dota_hud_error_item_cant_be_dropped"	"Ain't Droppable"
"dota_hud_error_cant_move_item_to_stash"	"Can't Move T' Stash"
"dota_hud_error_no_charges"	"No Uses"
"dota_hud_error_secret_shop_not_in_range"	"Black Market Not In Range"
"dota_hud_error_side_shop_not_in_range"	"Side Market Not In Range"
"dota_hud_error_not_enough_gold"	"Ye Be Needin' More Coin"
"dota_hud_error_hero_cant_be_denied"	"Admiral Ain't Deniable"
"dota_hud_error_cant_deny_health_too_high"	"Ye Target's Life Be Too High T' Deny"
"dota_hud_error_cant_give_item_to_enemy"	"Can't Give Loot T' Foes"
"dota_hud_error_target_cant_take_items"	"Target Can't Take Loot"
"dota_hud_error_cant_pick_up_item"	"Yer Stash is Full Cap'n!"
"dota_hud_error_cant_sell_shop_not_in_range"	"No Market In Range"
"dota_hud_error_disallowed_item"	"Loot Ain't Allow'd fer This Admiral"
"dota_hud_error_cant_sell_item"	"Can't Be Sold"
"dota_hud_error_cant_sell_item_while_dead"	"Can't Sell Loot Whilst Dead"
"dota_hud_error_item_out_of_stock"	"Loot ain't in Stock"
"dota_hud_error_ability_is_hidden"	"Skill Ain't Active"
"dota_hud_error_unit_cant_move"	"Can't Move"
"dota_hud_error_target_out_of_range"	"Target Be Out O' Range"
"dota_hud_error_cant_pick_up_runes"	"Can't Use Runes"
"dota_hud_error_cant_pick_up_items"	"Can't Take Loot"
"dota_hud_error_unit_cant_attack"	"Can't Attack"
"dota_hud_error_cant_quick_cast_at_location"	"Too Close T' Stronghold"
"dota_hud_error_must_target_tree"	"Skill Must Target a Tree"
"dota_hud_error_cant_target_unexplored"	"Skill Can't Target Unexplored Regions"
"dota_hud_error_only_cast_on_own_ward"	"Skill Can't Target Wards That Don't Belong T' Ye"
"dota_hud_error_only_cast_mana_units"	"Skill Can't Target Units Wit'out Rum"
"dota_hud_error_no_wards_here"	"Can't put'cher Ward there"
"dota_hud_error_no_corpses"	"Nary a Corpse in Sight"
"dota_hud_error_doom_already_devouring"	"Finish What Yer Eatin' First"
"dota_hud_error_ability_cant_upgrade_no_points"	"Ye 'Ave Nay Skill Upgrade Tallys T' Spend"
"dota_hud_error_ability_cant_upgrade_at_max"	"Skill Be At Max Rank"
"dota_hud_error_ability_inactive"	"Skill Ain't Active"
"dota_hud_error_ability_cant_upgrade_hero_level"	"Skill Upgrade Requires Admiral Rank %s1"
"dota_hud_error_item_not_in_unit_inventory"	"Thar Be No Loot In Chosen Crew's Inventory"
"dota_hud_error_cant_glyph"	"Rechargin'..."
"dota_hud_error_cant_drag_channeling_item"	"Ye Be Usin' This"
"dota_cursor_silenced"	"Muted!"
"dota_cursor_muted"	"Gagged!"
"dota_cursor_cooldown"	"%s1 Cooldown Left!"
"dota_cursor_no_mana"	"Arr! No Rum!"
"dota_item_panel_back"	"< ASTERN t' %s1"
"dota_item_panel_back_short"	"< ASTERN"
"DOTA_KillCam_ProTipHeader"	"TRY THIS NEXT TIME:"
"DOTA_KillCam_YourHealth"	"Yer Life"
"DOTA_KillCam_Delivers"	"delivered "
"DOTA_KillCam_Damage"	"%s1 damage "
"DOTA_KillCam_Using"	"usin' "
"DOTA_KillCam_Ability"	"%s1"
"DOTA_KillCam_AutoAttackReceived"	"Received "
"DOTA_KillCam_AutoAttack"	"from 1 attack"
"DOTA_KillCam_AutoAttack_Plural"	"from %s1 attacks"
"DOTA_KillCam_ShowMeReplay"	"show me th' recordin'"
"DOTA_KillCam_CapYou"	"Ye"
"DOTA_KillCam_LowYou"	"ye"
"DOTA_KillCam_Killed"	" murdered"
"DOTA_KillCam_Yourself"	"yerself"
"DOTA_KillCam_HaveDied"	" 'ave been slain."
"DOTA_GAMEPLAY_USE_TANGOS_NAME"	"Vegetarian"
"DOTA_GAMEPLAY_USE_TANGOS_DESC"	"Consume 300 trees usin' only Tangoes."
"DOTA_PERSONA_GAMES_PLAYED_FIRST_NAME"	"First One's Fer nothin'"
"DOTA_PERSONA_GAMES_PLAYED_FIRST_DESC"	"Complete yer very first battle o' Dota 2"
"DOTA_PERSONA_GAMES_PLAYED_TEN_NAME"	"Just A Taste"
"DOTA_PERSONA_GAMES_PLAYED_TEN_DESC"	"Fight 10 battles"
"DOTA_PERSONA_GAMES_PLAYED_HUNDRED_NAME"	"Hooked"
"DOTA_PERSONA_GAMES_PLAYED_HUNDRED_DESC"	"Fight 100 battles"
"DOTA_PERSONA_GAMES_PLAYED_THOUSAND_NAME"	"Y'Arr! I Can Abandon Ship Any Moment"
"DOTA_PERSONA_GAMES_PLAYED_THOUSAND_DESC"	"Fight 1000 battles"
"DOTA_PERSONA_GAMES_PLAYER_PARTY_NAME"	"Drinkin' Time"
"DOTA_PERSONA_GAMES_PLAYER_PARTY_DESC"	"Fight a battle while in a brawlfindin' party"
"DOTA_PlayerLoading"	"Fetchin'"
"DOTA_PlayerFinishedLoading"	"Ready"
"DOTA_SHOP_NAME_BASIC"	"HOME MARKET"
"DOTA_SHOP_NAME_RECIPE"	"RECIPE MARKETS"
"DOTA_SHOP_NAME_SECRET"	"BLACK MARKET"
"DOTA_SHOP_NAME_SIDE"	"SIDE MARKET"
"DOTA_SHOP_NAME_SUGGEST"	"SUGGEST"
"DOTA_SHOP_NAME_SEARCH"	"SCOUR"
"DOTA_SUBSHOP_CONSUMABLES"	"Consumables"
"DOTA_SUBSHOP_ATTRIBUTES"	"Attributes"
"DOTA_SUBSHOP_WEAPONS_ARMOR"	"Equipment"
"DOTA_SUBSHOP_MISC"	"Miscellany"
"DOTA_SUBSHOP_RECIPE_BASICS"	"Trinkets"
"DOTA_SUBSHOP_RECIPE_SUPPORT"	"Support"
"DOTA_SUBSHOP_RECIPE_MAGICS"	"Magical"
"DOTA_SUBSHOP_RECIPE_DEFENSE"	"Armor"
"DOTA_SUBSHOP_RECIPE_WEAPONS"	"Weaponry"
"DOTA_SUBSHOP_RECIPE_ARTIFACTS"	"Relics"
"DOTA_SUBSHOP_SECRET"	"Black Market"
"DOTA_SUBSHOP_SIDE_PAGE_1"	"Page 1"
"DOTA_SUBSHOP_SIDE_PAGE_2"	"Page 2"
"DOTA_SHOP_REQUIREMENTS"	"RECIPE COMPONENTS"
"DOTA_SHOP_SETQUICKBUY"	"Set Quick Buy"
"DOTA_Shop_Recipe"	"Recipe"
"DOTA_Shop_Search_Field_Default"	"Scour Loot"
"DOTA_Shop_Item_Error_Need_SecretShop"	"Requires Black Market"
"DOTA_Shop_Item_Error_Need_SideShop"	"Requires Side Market"
"DOTA_Shop_Item_Error_Out_of_Stock"	"Booty be out o' Stock"
"DOTA_Shop_Item_Error_Disallowed"	"Ain't allowed fer this Admiral"
"DOTA_Shop_Item_Error_Cant_Afford"	"Not 'Nuff Coins"
"DOTA_Shop_Item_Already_Owned"	"Already Own'd"
"DOTA_Shop_Tip_Mouse_Buttons"	"Ahoy! 'Tis th' Item Shop\n\nLEFT JAB on a piece o' loot icon select it.\nRight JAB on a piece o' loot t' acquire it."
"DOTA_Shop_Tip_Search"	"Scour\n\nTh' scour box below'll help ye find loot by name."
"DOTA_Item_Tooltip_Sell_Price"	"Sell Price: %s1"
"DOTA_Item_Tooltip_Sell_Price_Time"	"Sell Price: %s1 ( %s2 )"
"DOTA_SpectatorMode_Directed"	"Directed Spyglass"
"DOTA_SpectatorMode_FreeCam"	"Free Roam"
"DOTA_SpectatorMode_PlayerView"	"Scallywag Perspective"
"DOTA_SpectatorMode_HeroChase"	"Admiral Chase"
"DOTA_SpectatorAudio_None"	"ARR, NO BROADCASTER"
"DOTA_SpectatorFOW_BothTeams"	"Fog: Both Crews"
"DOTA_Spectator_SpectatorMode"	"Lookout Mode:"
"DOTA_Spectator_HeroList"	"Admirals:"
"DOTA_Spectator_FOWLabel"	"Fog o' War:"
"DOTA_Spectator_NumSpecs"	"Lookouts: %s1"
"DOTA_RPSTATUS_STARTGAME"	"Startin'..."
"DOTA_GameEnd_PointsEarned"	"Ye've earned <font color='#7AD1F2'>%s1</font> tallies!"
"DOTA_GameEnd_PointsLevelEarned"	"Ye've earned <font color='#7AD1F2'>%s1</font> tallies an' reached rank <font color='#7AD1F2'>%s2</font>!"
"DOTA_Broadcaster_Channel"	"%s1"
"DOTA_Broadcaster_Lang_0"	"English"
"DOTA_Broadcaster_Lang_1"	"German"
"DOTA_Broadcaster_Lang_2"	"French"
"DOTA_Broadcaster_Lang_3"	"Italian"
"DOTA_Broadcaster_Lang_4"	"Korean"
"DOTA_Broadcaster_Lang_5"	"Spanish"
"DOTA_Broadcaster_Lang_6"	"Chinese"
"DOTA_Broadcaster_Lang_7"	"Chinese"
"DOTA_Broadcaster_Lang_8"	"Russian"
"DOTA_Broadcaster_Lang_9"	"Thai"
"DOTA_Broadcaster_Lang_10"	"Japanese"
"DOTA_Broadcaster_Lang_11"	"Portugese"
"DOTA_Broadcaster_Lang_12"	"Polish"
"DOTA_Broadcaster_Lang_13"	"Danish"
"DOTA_Broadcaster_Lang_14"	"Dutch"
"DOTA_Broadcaster_Lang_15"	"Finnish"
"DOTA_Broadcaster_Lang_16"	"Norwegian"
"DOTA_Broadcaster_Lang_17"	"Swedish"
"DOTA_Paused"	"Battle be halt'd"
"GameUI_ServerConnectOutOfDate"	"Th' port be not updated t' th' most recent copy o' th' adventure.\n"
"GameUI_ServerChallengeIncorrect"	"Th' port be not respondin' with th' correct challenge now.\nIt may be out o' date.\n"
"GameUI_ServerInsecure"	"Ye are in non-lock'd mode. Ye must restart before ye can connect to lock'd ports.\n"
"GameUI_ServerRejectBadChallenge"	"'Tis a bad challenge.\n"
"GameUI_ServerRejectBadPassword"	"Foul watchword.\n"
"GameUI_ServerRejectServerFull"	"Port be full.\n"
"GameUI_ServerRejectBanned"	"Ye 'ave been marooned from this port.\n"
"GameUI_ServerRejectFailedChannel"	"Fail'd t' make a net channel.\n"
"GameUI_ServerRejectOldVersion"	"Th' port you're tryin' t' board t' is runnin'\nan older style o' th' adventure.\n"
"GameUI_ServerRejectBadSteamKey"	"Yer Steam key length ain't valid\n"
"GameUI_ServerRejectOldProtocol"	"This port be usin' an older protocol than yer client.\n"
"GameUI_ServerRejectNewProtocol"	"This port be usin' a newer order than yer client.\n"
"GameUI_ServerRejectInvalidConnection"	"Yer connection ain't valid.\n"
"GameUI_ServerRejectInvalidCertLen"	"Yer authentication certificate length ain't valid.\n"
"GameUI_ServerRejectInvalidSteamCertLen"	"STEAM certificate length error!\n"
"GameUI_ServerRejectSteam"	"STEAM validation be reject'd\n"
"GameUI_ServerRejectGS"	"GSCreateLocalUser fail'd\n"
"GameUI_ServerNoLobby"	"Arr, we couldn't go an' find th' bleedin' adventure!\n"
"GameUI_ServerRequireSteams"	"Th' port requires that ye be runnin' Steam.\n"
"GameUI_ServerAuthDisabled"	"Authentication disabled.\n"
"GameUI_ServerCDKeyAuthInvalid"	"CD Key authentication be invalid fer internet ports.\n"
"GameUI_ServerInvalidCDKey"	"Yer CD Key ain't valid.\n"
"GameUI_ServerCDKeyInUse"	"Yer CD Key is already bein' used.\n"
"GameUI_ClientRetryLimit"	"Arr, we can't dock th' port, Cap'n.\n"
"GameUI_ClientBadServerAddress"	"Bad port address.\n"
"GameUI_ClientStringTableError"	"Yer string table data's be different from th' port, amend yer adventure.\n"
"GameUI_ClientUnableToCRCMap"	"Unable t' be calculatin' th' map checksum.\n"
"GameUI_ClientNoMap"	"Unable t' fetch chart specified by port.\n"
"GameUI_ClientDifferentMap"	"Yer chart differs from th' port, amend yer adventure.\n"
"GameUI_ClientUnableToCRCDLL"	"Unable t' be calculatin' th' client side's dll checksum.\n"
"GameUI_ClientConnectionTimedOut"	"Boardin' th' port timed out.\n"
"GameUI_ClientServerShutdown"	"Port goin' under.\n"
"GameUI_ClientMissingModel"	"Boardin' can't finish due t' a missin' model.\n"
"GameUI_ClientConsistencyFail"	"Dockin' abort'd due t' th' port enforcin' model consistency.\n"
"report_text_abuse"	"Insultin'"
"report_text_abuse_desc"	"They be ruinin' th' parley fer th' rest o' us"
"report_voice_abuse_desc"	"They be insultin' everyone"
"report_feeding"	"Mutiny"
"report_feeding_desc"	"Th' lad sucked on purpose t' try t' drag th' rest o' th' crew under wit' him"
"report_ability_abuse_desc"	"They be usin' what ever's in their might t' harm their own shipmates"
"commend_friendly"	"Friendly"
"commend_friendly_desc"	"Methinks they be pretty nice lads"
"commend_forgiving"	"Merciful"
"commend_forgiving_desc"	"I believe they be quite merciful"
"commend_teaching"	"Teachin'"
"commend_teaching_desc"	"Aye, methinks they be a fine teacher"
"commend_leadership_desc"	"Arr, methinks they were a fine Cap'n"
"dota_day"	"%s1 sunrise"
"dota_days"	"%s1 sunrises"
"DOTA_Tooltip_Ability_Build_Comment"	"%s1"
"DOTA_Tooltip_Item_Build_Comment"	"%s1"
"Dota_Lobby_Kick"	"Boot"
"commend_submitted"	"Yer applause be well on its way: A hearty thanks t' ye fer helpin' t' improve th' Dota 2 crews."
"report_submitted"	"Report be submitt'd: Thanks fer helpin' t' improve th' Dota 2 crew."
"duplicate_report"	"Ye 'ave already submitt'd feedback fer this scallywag."
"update_notes"	"AMENDMENTS"
"feedback_forums"	"FEEDBACK TARVERNS"
"place_holder"	"BOTTLE\nOF TH' RUM"
"dota_hud_error_game_is_paused"	"Battle be Halt'd"
"TimeOfDay_Day"	"Sunrise"
"TimeOfDay_Night"	"Sunset"
"TimeOfDay_am"	"a.m."
"TimeOfDay_pm"	"p.m."
"DOTA_Lobby_Watchable"	"Permit lookouts"
"dota_matchgroup_useast"	"US East"
"dota_matchgroup_uswest"	"US West"
"dota_matchgroup_cn"	"China"
"dota_matchgroup_sea"	"SE Asia"
"DOTA_Game_Settings"	"ADVENTURE RIGGINGS"
"UI_MED"	"MED"
"UI_HIGH"	"HIGH"
"UI_DEFAULTS"	"DEFAULTS"
"DOTA_Audio_Settings"	"NOISE RIGGINGS"
"UI_Enable_Voice"	"TURN ON JABBERIN'"
"UI_Voice_Transmit_Vol"	"JABBERIN' TRANSMISSION LOUDNESS"
"UI_Voice_Receive_Vol"	"INCOMIN' JABBERIN' LOUDNESS"
"UI_Boost_Mic"	"BOOST MIC GAIN"
"UI_Not_Implemented"	"* - Not 'ere Right Now"
"UI_No_Captions"	"No Captions"
"UI_Subtitles_Effects"	"Subtitles and Effects"
"UI_Subtitles"	"Subtitles"
"UI_Headphones"	"Earpieces"
"UI_2_Speakers"	"2 Noisy Boxes"
"UI_4_Speakers"	"4 Noisy Boxes"
"UI_5_1_Speakers"	"5.1 Noisy Boxes"
"UI_7_1_Speakers"	"7.1 Noisy Boxes"
"DOTA_Warning"	"WARNIN'"
"Dota_Lobby_Set_Filter"	"SIFT"
"DOTA_More_ellipses"	"more..."
"DOTA_RecentEvent"	"Show Recent Grog Fest"
"DOTA_SelectAllOthers"	"Choose All Other Units"
"DOTA_Summary"	"Notes"
"DOTA_Lore"	"Lore"
"DOTA_SkillsLabel"	"Skills:"
"DOTA_RoleLabel"	"Role:"
"DOTA_Tooltip_topbar_dashboard"	"Dashboard"
"DOTA_Tooltip_topbar_chat"	"Parley"
"DOTA_Tooltip_topbar_score"	"Tallyboard"
"DOTA_Tooltip_topbar_guide"	"Guide"
"DOTA_Tooltip_topbar_log"	"Log"
"DOTA_Tooltip_topbar_stats"	"Spoils"
"DOTA_Tooltip_topbar_spectate"	"Watch"
"DOTA_Tooltip_topbar_disconnect"	"Depart"
"DOTA_Chat_Bot_LeaveRoshan"	"Leavin' Th' Kraken"
"DOTA_Chat_Bot_TeamRoam"	"Roamin' t' gank %s1"
"DOTA_TutorialBody_RoundOne"	"Sniper has a ranged attack with nary a projectile, so th' hit occurs very quickly! Aye, but 'e hits like a weak babe, so time yer shots."
"DOTA_TutorialTask_Sniper"	"Last hit as Sniper."
"DOTA_TutorialBody_RoundTwo"	"Anti-Mage be havin' a very hasty attack animation an' fast attack rate - close combat admirals be generally easier t' last hit wit'."
"DOTA_TutorialTask_Antimage"	"Last hit as Anti-Mage."
"DOTA_TutorialBody_RoundThree"	"Mirana be havin' a good attack animation an' projectile speed, but awful hittin' power, makin' th' lass' o' moderate difficulty."
"DOTA_TutorialTask_Mirana"	"Last hit as Mirana."
"DOTA_TutorialBody_RoundFour"	"Crystal Maiden's attackin' animation be havin' a wind-up time an' a slow movin' projectile, so yer gonna have a hell o' a time tryin' t' finish off units."
"DOTA_TutorialTask_CrystalMaiden"	"Last hit as Crystal Maiden."
"DOTA_TutorialBody_RoundFive"	"Shadow Fiend be great at plunderin' creeps wi' his good attack animation, high damage, an' skill Shadowraze - be seein' how hasty ye can plunder this here lane."
"DOTA_TutorialTitle_LastHitEnd"	"Battle Over"
"DOTA_TutorialBody_LastHitEnd"	"Yer tally: "
"Dota_Lobby_Join_Slot"	"Board Slot"
"Dota_Lobby_Ready"	"READY"
"Dota_Lobby_Choose_Slot"	"PICK YER PLACE O'ER ON TH' RIGHT"
"Dota_Lobby_Setup_Button"	"Battle Setup"
"Dota_Lobby_Cancel_Game"	"Belay Battle"
"Dota_Lobby_Start_Game"	"START BATTLE"
"Dota_Lobby_Broadcasters"	"Overseers"
"Dota_Lobby_Become_Broadcaster"	"Board Channel"
"DOTA_UI_Submit"	"CAST T' SEA"
"dota_friends"	"MATEYS"
"friends_playing_dota"	"PLUNDERIN' DOTA"
"friends_online"	"SEAFARIN'"
"friends_offline"	"LANDLUBBIN'"
"party_accepted"	"IN PARTY"
"party_pending"	"(%s1 PENDIN')"
"party_declined"	"
"
"most_played_heroes"	"MOST PLUNDER'D ADMIRALS"
"heroes_played_title"	"ADMIRALS YE'VE BEEN"
"dota_hero"	"ADMIRAL"
"chat_send"	"CAST"
"chat_members"	"PIRATES"
"chat_add_channel"	"ADD PARLEY CHANNEL"
"chat_select_channel"	"Choose a parley channel t' board"
"dota_report_title_commend"	"APPLAUD SCALLYWAG"
"dota_report_title_report"	"REPORT SCALLYWAG"
"dota_report_leave_comment"	"Leave a ramblin' note..."
"dota_reports_remaining"	"Reports Remainin': %s1"
"dota_reports_total"	"Total reports casted out: %s1"
"dota_commends_remaining"	"Applauds Left: %s1"
"dota_commends_total"	"Total applauds casted out: %s1"
"report_voice_abuse"	"Jabberin' abuse"
"report_ability_abuse"	"Deliberate Skill Abuse"
"commend_leadership"	"Captaincy"
"blog"	"JOURNAL"
"dota_soon"	"COMIN' SOON"
"DOTA_filter_private_lobby"	"Filter hidden lobbies by watchword"
"DOTA_practice_lobby_list"	"CURRENT HIDDEN LOBBIES"
"DOTA_Video_Settings"	"MOVIN' PICTURE RIGGINGS"
"UI_Advanced"	"ADVANCED"
"UI_Adanced_Settings"	"EXTRA RIGGINGS
"
"UI_Overlays"	"OVERLAYS"
"UI_Video_Test"	"MOVIN' PICTURE TRIAL"
"UI_Hero_Global_Bindings"	"ADMIRALTITLE'S/GLOBAL BINDIN'S"
"UI_Legacy_Keys"	"Legacy Admiral Keys"
"UI_Ultimate"	"Ultimate"
"UI_Ability1"	"Skill 1"
"UI_Ability2"	"Skill 2"
"UI_Ability3"	"Skill 3"
"UI_Ability4"	"Skill 4"
"UI_Ability5"	"Skill 5"
"UI_View_Controls"	"VIEW CONTROLS"
"UI_Unit_Actions"	"UNIT ACTIONS"
"UI_Panel_Activation"	"PANEL ACTIVATION"
"DOTA_UserMenu_CommendPlayer"	"Applaud Scallywag"
"DOTA_UserMenu_ReportPlayer"	"Report Scallywag"
"dota_hud_error_unit_dead"	"Dead"
"dota_hud_error_cant_disassemble_stash_out_of_range"	"Too far from ye booty"
"dota_hud_error_cant_toss"	"Nuthin' T' Toss"
"dota_hud_error_queue_full"	"Order Line be Pack'd"
"DOTA_RP_FINDING_MATCH"	"Scourin' Fer A Battle"
"dota_item_build_default"	"Usual Loot Build"
"dota_waiting_for_players_connecting"	"Boardin'..."
"dota_waiting_for_players_loading"	"Fetchin'..."
"dota_waiting_for_players_ready"	"Ready"
"dota_waiting_for_players_failed"	"Failed"
"dota_item_build_save_failed"	"Archive Failed"
"dota_item_build_save_failed_filename"	"Bad Filename"
"dota_item_build_save_success"	"Loot Build Archived"
"dota_hud_error_cant_purchase_inventory_full"	"Arr, Can't Acquire, Yer Chest be Full"
"DOTA_UserMenu_IgnorePlayer"	"Ignore Scallywag"
"DOTA_UserMenu_UnignorePlayer"	"Unignore Scallywag"
"DOTA_SpectatorsAreWatchingYourGame"	"Arr, thar be %s1 lookouts watchin' yer battle right now."
"spectate_autospeed_label"	"Autospeed"
"DOTA_Chat_CourierRespawnedGood"	"Radiant's courier be reportin' fer duty."
"DOTA_Chat_CourierRespawnedBad"	"Dire's courier be reportin' fer duty."
"DOTA_MiniKillcam_KilledByNeutral"	"KILL'D BY\nNeutrals!"
"npc_dota_hero_obsidian_destroyer"	"Outworld Devourer"
"DOTA_Lobby_Version"	"VERSION"
"DOTA_Lobby_Game_Prefs"	"LOBBY RIGGINGS"
"DOTA_Lobby_Prefs_Game_Mode"	"BATTLE TYPE"
"DOTA_Lobby_Prefs_Region"	"PORT LOCATION"
"DOTA_Lobby_Prefs_Bots"	"DUMMIES"
"DOTA_Lobby_Prefs_Cheats"	"CHEATS"
"DOTA_Lobby_Prefs_Spectators"	"LOOKOUTS"
"DOTA_Lobby_Prefs_Version"	"VERSION"
"DOTA_Lobby_Unassigned"	"UNASSIGNED SCALLYWAGS"
"dota_version_current"	"Latest"
"dota_version_stable"	"Tourney"
"DOTA_Lobby_MM_pref"	"FILL IN BRAWLFINDIN' PREFERENCES"
"infraction_type_label"	"Choose a category"
"infraction_comment_label"	"More information:"
"update_archive"	"PREVIOUS AMENDMENTS"
"dota_career_profile"	"CAREER LOG"
"dota_profile_title"	"DOTA 2 - PERSONAGE"
"dota_profile_prefs"	"Persona Preferences"
"dota_profile_recent_games"	"Most-recent Battles"
"dota_profile_commendations"	"Rounds o' Applause"
"dota_lobby_type_matchmaking"	"Free Water Brawlfindin'"
"dota_lobby_type_tutorial"	"Guide"
"dota_featured_hero"	"Featured Admiral:"
"dota_load_game_button"	"LOAD BATTLE"
"DOTA_Channel_Bar_Default"	"Channelin'"
"DOTA_Channel_Bar_Time"	"Channellin' %s1"
"watch_filter_label"	"Filter by"
"UI_player_name_label"	"CAP'N TITLE (PRECISE MATCH)"
"UI_hero_name_label"	"ADMIRAL TITLE"
"UI_game_mode_label"	"BATTLE TYPE"
"UI_skill_level_label"	"SKILL RANK"
"UI_date_range_label"	"DATE RANGE"
"UI_tournament_label"	"TOURNEY BATTLE"
"MD_MATCH_LABEL"	"BATTLE ID"
"MD_DATE_LABEL"	"DATE"
"MD_DURATION_LABEL"	"DURATION"
"MD_WINNER_LABEL"	"WINNIN' CREW"
"MD_PLAYER_L"	"CAP'N"
"MD_LEVEL_L"	"RANK"
"MD_HERO_L"	"ADMIRAL"
"MD_ITEMS_L"	"LOOT"
"MD_GOLD_L"	"COIN"
"MD_DENIES_L"	"DENIES"
"MD_GOLD/MIN_L"	"COIN/MIN"
"MD_XP/MIN_L"	"XP/MIN"
"MD_Downloading_Replay"	"Receivin' Playback:"
"MD_Replay_Unavailable"	"Playback Ain't Available"
"MD_reveal_button"	"Reveal th' winnin' crew"
"DOTA_WATCH_GAME_STATUS"	"Watch Battle State"
"DOTA_MiniKillcam_TellMeMore"	"Arr! Tell Me More Matey!"
"npc_dota_lycan_wolf1"	"Lycan Wolf"
"npc_dota_lycan_wolf2"	"Lycan Wolf"
"npc_dota_lycan_wolf3"	"Lycan Wolf"
"npc_dota_lycan_wolf4"	"Lycan Wolf"
"dota_profile_successful_heroes"	"Most Successful Admirals"
"DOTA_AutocastAbility0"	"Autocast Skill 1"
"DOTA_AutocastAbility1"	"Autocast Skill 2"
"DOTA_AutocastAbility2"	"Autocast Skill 3"
"DOTA_AutocastAbility3"	"Autocast Skill 4"
"DOTA_AutocastAbility4"	"Autocast Skill 5"
"DOTA_AutocastAbility5"	"Autocast Ultimate"
"DOTA_CourierAbility1"	"Return T' Ship"
"DOTA_CourierAbility3"	"Put Loot In Stash"
"DOTA_CourierAbility2"	"Head T' Secret Shop"
"DOTA_CourierAbility6"	"Speed Burst"
"DOTA_NeutralAbility1"	"Neutral Skill 1"
"DOTA_NeutralAbility2"	"Neutral Skill 2"
"DOTA_NeutralAbility3"	"Neutral Skill 3"
"DOTA_NeutralAbility4"	"Neutral Skill 4"
"DOTA_Aura_Active"	"Aura: Active"
"DOTA_Aura_Inactive"	"Aura: Inactive"
"npc_dota_hero_brewmaster"	"Brewmaster"
"npc_dota_hero_shadow_demon"	"Shadow Demon"
"npc_dota_hero_lone_druid"	"Lone Druid"
"npc_dota_hero_chaos_knight"	"Chaos Knight"
"npc_dota_lone_druid_bear1"	"Spirit Beast"
"npc_dota_lone_druid_bear2"	"Spirit Beast"
"npc_dota_lone_druid_bear3"	"Spirit Beast"
"npc_dota_lone_druid_bear4"	"Spirit Beast"
"npc_dota_brewmaster_earth_1"	"Earth"
"npc_dota_brewmaster_earth_2"	"Earth"
"npc_dota_brewmaster_earth_3"	"Earth"
"npc_dota_brewmaster_earth_4"	"Earth"
"npc_dota_brewmaster_storm_1"	"Storm"
"npc_dota_brewmaster_storm_2"	"Storm"
"npc_dota_brewmaster_storm_3"	"Storm"
"npc_dota_brewmaster_storm_4"	"Storm"
"npc_dota_brewmaster_fire_1"	"Fire"
"npc_dota_brewmaster_fire_2"	"Fire"
"npc_dota_brewmaster_fire_3"	"Fire"
"npc_dota_brewmaster_fire_4"	"Fire"
"DOTA_Scoreboard_kills"	"MURDERS"
"DOTA_Scoreboard_deaths"	"WATERY GRAVES"
"DOTA_Scoreboard_assists"	"ASSISTS"
"DOTA_Scoreboard_ultimate"	"ULTIMATE"
"DOTA_Lobby_Game_Offline_Setup"	"LANDLUBBIN' PRACTICE LOBBY RIGGINGS"
"DOTA_Lobby_Prefs_Password"	"WATCHWORD"
"DOTA_Lobby_Prefs_Cheats_caps"	"CHEATS"
"UI_ENTER_LOBBY_PASSWORD"	"FILL IN LOBBY WATCHWORD"
"UI_Save_Settings"	"HOIST RIGGINGS"
"UI_Edit_Settings"	"AMEND RIGGINGS"
"dota_region_stockholm"	"Stockholm"
"dota_region_amsterdam"	"Amsterdam"
"dota_region_automatic_desc"	"Pick me a port that be best fer me location."
"dota_region_select_desc"	"Let me pick ports from all th' seas."
"Average_wait_time"	"Average halt time: %s1"
"dota_matchgroup_hk"	"Hong Kong"
"UI_region_settings_command"	"CHOOSE BRAWLFINDIN' SEAS"
"DOTA_Hero_Selection_Filter_Suggestions"	"CREW'S SUGGESTIONS (%s1)"
"DOTA_Hero_Selection_AdvFilter_Attack_Melee"	"Close Combat"
"DOTA_Hero_Selection_AdvFilter_Attack_Ranged"	"Ranged"
"DOTA_Hero_Selection_AdvFilter_MyHero_Favorites"	"Yer Favorites"
"DOTA_Hero_Selection_AdvFilter_MyHero_BestAs"	"Yer Best"
"DOTA_Hero_Selection_AdvFilter_MyHero_Recent"	"Recently Plunder'd As"
"DOTA_ToolTip_Ability_Channeled"	"Channel'd"
"DOTA_ToolTip_Targeting_AlliedHeroes"	"Allied Admirals"
"DOTA_Tooltip_Targeting_All_Heroes"	"Admirals"
"DOTA_ToolTip_Targeting_Units"	"Units"
"unknown_wait_time"	"Unknown Halt Time"
"matchmaking_settings_label"	"BRAWLFINDIN' RIGGINGS"
"lobby_settings_label"	"LOBBY RIGGINGS"
"matchmaking_gamemode_label"	"BATTLE TYPES"
"matchmaking_regions_label"	"SEAS"
"matchmaking_select"	"CHOOSE"
"dota_lobby_type_practice_games"	"PRACTICE BATTLES"
"dota_lobby_type_private_games"	"HIDDEN BATTLES"
"dota_lobby_tutorials"	"TRAININ'"
"dota_lobby_offline_title"	"LANDLUBBIN' PRACTICE LOBBY"
"dota_match_elapsed"	"TIME PASSED:"
"dota_safe_to_abandon"	"This battle be safe t' leave."
"DOTA_create_online_lobby"	"Craft a seafarin' lobby"
"DOTA_create_online_lobby_desc"	"Craft a hidden lobby when ye wish t' plunder wit' yer mateys."
"DOTA_create_online_lobby_desc_bullets"	"- Plunder planned battles against certain scallywags or crews. \n- Recruit mateys an' fill empty scallywag slots wit' dummies. \n- Hide th' lobby by riggin' a watchword in LOBBY RIGGINGS."
"DOTA_no_friend_lobbies"	"Yer mateys dun 'ave lobbies."
"DOTA_no_private_lobbies"	"Nary a hidden lobby found."
"DOTA_find_lobby"	"SEEK A LOBBY"
"lobby_password_label"	"LOBBY WATCHWORD"
"Find_lobby"	"Seek Lobby"
"DOTA_Matchmaking_NoGameMode_Error"	"Would ye kindly pick a battle type?"
"UI_APPLY"	"APPLY"
"UI_HERO"	"ADMIRAL"
"UI_COURIER"	"COURIER"
"UI_NEUTRALS"	"NEUTRALS"
"waiting_for_players_title"	"WAITIN' FER SCALLYWAGS"
"party_block_player"	"Cease all note writin' from th' Cap'n o' th' party"
"DOTA_PartyKicked_Header"	"Booted From Party"
"DOTA_PartyKicked_Message"	"Avast! Ye've been thrown overboard from th' party by th' Cap'n."
"dota_hud_error_item_muted"	"Loot be Muted"
"dota_game_stats"	"SPOILS"
"dota_results"	"RESULTS"
"UI_game_mode_command"	"CHOOSE BATTLE TYPES"
"UI_match_id_label"	"BATTLE ID"
"watch_or_filter_by_label"	"Or, filter by"
"MD_Finding_Replay"	"Findin' Recordin'..."
"match_details_timeout"	"Request fer Battle ID %s1 timed out."
"match_details_denied"	"Access t' Battle ID %s1 denied."
"match_details_failed"	"Broken Battle ID %s1."
"DOTA_RP_WATCHING_REPLAY"	"Viewin' A Recordin'"
"DOTA_RP_ONLINE"	"Seafarin'"
"DOTA_RP_BUSY"	"Swashbucklin'"
"DOTA_RP_AWAY"	"Below Deck"
"DOTA_RP_SNOOZE"	"Snorin'"
"DOTA_RP_LOOKING_TO_TRADE"	"Lookin' T' Barter"
"DOTA_RP_LOOKING_TO_PLAY"	"Lookin' T' Plunder"
"dota_workshop_viewlegal"	"Legal Agreement"
"DOTA_KEYBIND_MENU_UNITACTIONS"	"UNIT ACTIONS"
"DOTA_KEYBIND_MENU_ABILITIES"	"SKILLS"
"DOTA_KEYBIND_MENU_ITEMS"	"LOOT"
"DOTA_KEYBIND_MENU_PLAYER"	"SCALLYWAG"
"DOTA_KEYBIND_MENU_METAGAME"	"METAGAME"
"DOTA_KEYBIND_MENU_SPECTATOR"	"LOOKOUT"
"DOTA_Inventory1"	"Inventory 1"
"DOTA_Inventory2"	"Inventory 2"
"DOTA_Inventory3"	"Inventory 3"
"DOTA_Inventory4"	"Inventory 4"
"DOTA_Inventory5"	"Inventory 5"
"DOTA_Inventory6"	"Inventory 6"
"DOTA_SpectatorForward"	"Lookout Spyglass Onwards"
"DOTA_SpectatorBack"	"Lookout Spyglass Astern"
"DOTA_SpectatorLeft"	"Lookout Spyglass Left"
"DOTA_SpectatorRight"	"Lookout Spyglass Right"
"DOTA_SpectatorGrip"	"Lookout Spyglass Grip"
"DOTA_SpectatorPause"	"Lookout Halt"
"DOTA_SpectatorIncreaseReplaySpeed"	"Increase Playback Speed"
"DOTA_SpectatorDecreaseReplaySpeed"	"Decrease Playback Speed"
"DOTA_SpectatorChat"	"Lookout Parley"
"DOTA_SpectatorScoreboard"	"Lookout Tallyboard"
"DOTA_SpectatorStatsHarvest"	"Lookout Harvest Spoils"
"DOTA_SpectatorStatsItem"	"Lookout Loot Spoils"
"DOTA_SpectatorStatsGold"	"Lookout Coin Graph"
"DOTA_SpectatorFOWBoth"	"Lookout FOW Both Crews"
"DOTA_SpectatorFOWRadient"	"Lookout FOW Radiant"
"DOTA_SpectatorFOWDire"	"Lookout FOW Dire"
"DOTA_Buyback"	"RETURN"
"DOTA_Stash"	"STASH"
"DOTA_Inventory_Grab_All"	"GRAB ALL"
"DOTA_Community_ViewPersona"	"See Persona"
"DOTA_Community_EditPersona"	"Amend Persona"
"DOTA_UI_Exit"	"SCRAM"
"DOTA_UI_Confirmation_Continue"	"Onward"
"DOTA_UI_Confirmation_Cancel"	"Belay"
"DOTA_Hero_Selection_Filter_Mode_SD"	"YER SINGLE DRAFT RIGGINGS"
"DOTA_Hero_Selection_Filter_Mode_RD"	"YER RANDOM DRAFT RIGGINGS"
"DOTA_Hero_Selection_Filter_PlayerLoadout"	"NON-ADMIRAL LOOT"
"DOTA_Hero_Selection_AdvFilter_MyHero_LeastUsed"	"Yer Least Used"
"DOTA_Hero_Selection_AdvFilter_MyHero_Items"	"Ye've Loot Fer"
"DOTA_Hero_Selection_HeroCount"	"[%s1 ADMIRALS]"
"DOTA_Hero_Selection_RandomSelect"	"Spin t' Random Admiral"
"DOTA_ToolTip_Damage_Magical"	"Magical"
"DOTA_ToolTip_Damage_Composite"	"Composite"
"UI_DISABLE_WINDOWS_KEY"	"DISABLE WINDOWS KEY"
"DOTA_UserMenu_TeamInvite"	"Recruit t' th' crew"
"team_label"	"YER CREW"
"team_players_online"	"%2 o' %3 be seafarin'"
"DOTA_TeamInvite_Success_Header"	"Crew Invite Cast"
"DOTA_TeamInvite_Error_Header"	"Can't Invite t' Crew"
"DOTA_TeamInvite_Failure_Header"	"Crew Invite Failed"
"DOTA_TeamInvite_Failure_Unspecified"	"Arr, an errarrrr happened out of the blue when attemptin' t' invite th' scallywag."
"DOTA_TeamInviteAccept_Failure_Header"	"Failed t' Board Crew"
"DOTA_TeamInviteAccept_Failure_Unspecified"	"An unexpected errarrrr occurred when attemptin' t' join th' crew."
"DOTA_TeamInviteAccept_Success_Header"	"Joined Crew"
"DOTA_TeamCreate_Error_Header"	"Failed t' Assemble Crew"
"DOTA_TeamCreate_Error_CreatorBusy"	"Ye can't form a crew while bein' invited t' a crew."
"DOTA_TeamCreate_Error_Unspecified"	"Shiver me timbers, somethin's gone amiss while tryin' t' create th' crew! Give it another go."
"DOTA_TeamDisband_Confirmation_Header"	"Disband Crew"
"DOTA_TeamDisbanded_Header"	"Crew Disbanded"
"DOTA_TeamDisbanded_Failure_Header"	"Failed t' Disband Team"
"DOTA_TeamDisbanded_Failure_Message"	"An unexpected errarrrr occurred when attemptin' t' disband th' crew."
"DOTA_TeamKick_Confirm_Header"	"To th' plank with this 'ere crewmate"
"DOTA_TeamKick_Success_Header"	"Thrown Scallywag Overboard"
"DOTA_TeamKick_Failure_Header"	"Kick Scallywag Failed"
"DOTA_TeamKicked_Header"	"Kicked From Crew"
"DOTA_TeamLeft_Header"	"Left Crew"
"UI_no_team_title"	"Ye're not part o' a crew"
"UI_no_team_desc"	"T' be matched against a crew ye must be part o' a crew wit' at least five scallywags. Ye can create 'n manage a crew in th' JABBER tab."
"dota_create_team_error_empty_name"	"Arr, ye haven't scribbled a name. Scribble one now."
"dota_create_team_error_empty_tag"	"Ye haven't declared a tag. Please declare one now."
"dota_create_team_error_name_taken"	"This name 'tis already taken. Please enter another one."
"dota_create_team_error_tag_taken"	"This crew name has already been taken. Scribble a different one."
"dota_create_team_error_too_long"	"Much too long."
"DOTA_Workshop_ConfirmFileDeletion"	"Confirm Purge"
"DOTA_Workshop_ConfirmFileDeletionDescription"	"Yarr. Throw ye items o'erboard? Th' be rough waters.."
"DOTA_Chat_UnpauseCountdown"	"Continuing in %s1..."
"DOTA_Chat_AutoUnpaused"	"Battle be automatically continued."
"npc_dota_hero_treant"	"Treant Protector"
"dota_region_brazil"	"Brazil"
"DOTA_Hero_Selection_Filter_Carry"	"CARRY"
"DOTA_Hero_Selection_Filter_Initiator"	"RUMBLE STARTER"
"DOTA_Hero_Selection_Filter_Ganker"	"SHANKER"
"DOTA_Hero_Selection_Filter_Support"	"REINFORCEMENT"
"DOTA_Hero_Selection_Filter_Pusher"	"PUSHER"
"DOTA_Hero_Selection_PipTooltip_Str"	"Main Attribute: Might"
"DOTA_Hero_Selection_PipTooltip_Agi"	"Main Attribute: Nimbleness"
"DOTA_Hero_Selection_PipTooltip_Int"	"Main Attribute: Wits"
"dota_hud_error_courier_cant_use_item"	"Loot ain't usable by Couriers"
"DOTA_Gold_Graph_Title"	"DIFF'RENCE IN COIN EARN'D"
"DOTA_XP_Graph_Title"	"DIFFERENCE IN XP EARNED"
"DOTA_Gold_Graph_Total"	"TOTAL COIN EARN'D"
"DOTA_XP_Graph_Total"	"TOTAL XP EARNED"
"DOTA_Workshop_SubmitError"	"Cast out Errarrrr!"
"DOTA_Workshop_Error_ContentFile"	"Could nah prepare ye stuff."
"DOTA_Workshop_Error_PreviewFile"	"Could nah prepare sneak peak o' ye paintin'."
"DOTA_SpectatorStatsXP"	"Lookout XP Spoils"
"DOTA_View_Lore"	"See Admiral Lore"
"DOTA_Chat_Taunt"	"%s1 taunts ye!"
"npc_dota_hero_meepo"	"Meepo"
"npc_dota_hero_ogre_magi"	"Ogre Magi"
"DOTA_Shared_Unit_Control_Title"	"SHARED UNIT CONTROL"
"DOTA_Shared_Unit_Control_Hero"	"Admiral"
"DOTA_Shared_Unit_Control_Units"	"Units"
"DOTA_Shared_Unit_Control_Disable_Help"	"Forgo Help"
"DOTA_Lobby_coop_bot_Setup"	"CO-OP DUMMY RIGGINGS"
"DOTA_Hero_Selection_LoadoutTitle"	"%s1 - %s2"
"DOTA_ToolTip_Damage_HP_Removal"	"LP Purge"
"dota_hud_error_cant_cast_on_considered_hero"	"Arr, Can't Target Creep Admirals"
"dota_hud_error_target_has_disable_help"	"Target be Rejectin' All Reinforcements"
"econ_new_items_title"	"NEW LOOT AHOY!"
"econ_tool_desc_title"	"CHANGE DESCRIPTION"
"econ_tool_desc_label"	"Current Description:"
"econ_tool_name_title"	"CHANGE TITLE"
"econ_tool_name_label"	"Current Title:"
"econ_store_title"	"MARKET"
"econ_loadout_title"	"ARMORY"
"econ_workshop_title"	"WORKSHOP"
"DOTA_StatTooltip_Buyback_Ready"	"Ready t' Return"
"DOTA_StatTooltip_Buyback_Cooldown"	"Return in %s1"
"ui_teammatchmaking"	"Crew Brawlfindin'"
"ui_teammatchmaking_status_desc"	"Waitin' fer crew members to enter crew brawlfindin'..."
"DOTA_Hero_Selection_Tooltip_FullDeck"	"GRID VIEWPORT (CTRL)"
"dota_profile_mini_team_party"	"CREWMATES"
"dota_profile_heroes_played"	"ADMIRALS YE'VE BEEN"
"dota_pb_title"	"PERFORMANCE"
"dota_chat_team_tab"	"Crew"
"DOTA_DisbandTeamButton"	"Disband"
"DOTA_Team_Created"	"BE MADE"
"DOTA_Team_Invite_Accepted_Desc"	"New crew members'll appear in th' 'Manage Crew' area under th' CREW tab."
"DOTA_TeamMatchmake_AlreadyMatch"	"Yer crew already be in a match."
"DOTA_TeamMatchmake_AlreadyFinding"	"Yer crew already be scourin' fer a battle."
"DOTA_TeamMatchmake_Full"	"Th' crew be full already."
"DOTA_TeamMatchmake_FailAdd"	"Couldn't add ye t' th' crew."
"DOTA_TeamMatchmake_FailAddCurrent"	"Couldn't add ye t' th' current crew."
"DOTA_TeamMatchmake_FailedTeamMember"	"Failed to get scallywag information."
"DOTA_TeamMatchmake_AlreadyGame"	"Can't begin scourin' fer another battle just yet, ye already be in th' midst of a battle!"
"DOTA_TeamMatchmake_FailGetParty"	"Arr, couldn't get current crew."
"dota_hud_error_cant_shop_auto_buy_enabled"	"Ye can't go about shoppin' when ye be set t' auto-buy"
"dota_create_team_error_no_logo"	"Don't ye want a crew flag? Ye didn't set one yet! Please set one now."
"GameUI_Disconnected"	"Departed from Port"
"GameUI_Disconnect_ServerInfoOverflow"	"Info data overflow"
"GameUI_Disconnect_TickMessage"	"Error writin' tick message"
"GameUI_Disconnect_StringTableMessage"	"Error writin' string table update message"
"GameUI_Disconnect_DeltaEntMessage"	"Error writing delta entities message"
"GameUI_Disconnect_TempEntMessage"	"Error writin' temp entities message"
"GameUI_Disconnect_SoundsMessage"	"Error writin' game sounds message"
"GameUI_Disconnect_SnapshotOverflow"	"Error reliable snapshot overflow"
"GameUI_Disconnect_SnapshotError"	"Error sendin' snapshot"
"GameUI_Disconnect_ReliableOverflow"	"Error reliable buffer overflow"
"GameUI_Disconnect_BadClientDeltaTick"	"Arr, yer delta ticks be out o' order."
"GameUI_Disconnect_NoMoreSplits"	"No more split screen slots"
"GameUI_Disconnect_Disconnected"	"Departed"
"GameUI_Disconnect_ReliableChannelOverflow"	"Overflow'd reliable channel"
"GameUI_Disconnect_LeavingSplit"	"Leavin' splitscreen"
"GameUI_Disconnect_DifferentClassTables"	"Port be usin' diff'rent class tables, whatever that is"
"GameUI_Disconnect_ConnectionClosing"	"Connection closing"
"GameUI_Disconnect_ConnectionLost"	"Arr, we lost connection, Cap'n"
"GameUI_Disconnect_BadRelayPassword"	"Foul relay watchword"
"GameUI_Disconnect_BadSpectatorPassword"	"Foul lookout watchword"
"GameUI_Disconnect_HLTVRestricted"	"SourceTV server be restrict'd t' local spectators (class C)"
"GameUI_Disconnect_HLTVUnavailable"	"No SourceTV relay be available Capt'n"
"GameUI_Disconnect_HLTVStop"	"SourceTV stop"
"GameUI_Disconnect_Kicked"	"Thrown Overboard"
"GameUI_Disconnect_BanAdded"	"Sent into exile"
"GameUI_Disconnect_KickBanAdded"	"booted and exiled"
"GameUI_Disconnect_SteamIDBanned"	"Arrr! STEAM UserID be exiled"
"GameUI_Disconnect_SteamIDInUse"	"Arrr! STEAM UserID already be in use fer this port"
"GameUI_Disconnect_SteamLogon"	"No Steam logon"
"GameUI_Disconnect_SteamInUse"	"Arrr! This Steam account be used in another location!"
"GameUI_Disconnect_SteamOwnership"	"Arrrr! This Steam ship dun 'ave th' adventure Capt'n!\nPlease set sail wit' th' correct Steam ship!"
"GameUI_Disconnect_SteamVAC"	"VAC bann'd from th' secure port"
"GameUI_Disconnect_SteamTicket"	"Invalid STEAM UserID Ticket"
"DOTA_Chat_Random"	"%s1, in a drunken stupor, blindly chose %s2"
"DOTA_Chat_RD_YourTurn"	"%s1's turn t' pick"
"DOTA_MiniKillcam_Wielding"	"%s1 be wieldin':"
"ui_teammatchmaking_view_team_button"	"See Crew"
"DOTA_Hero_Selection_PipTooltip_Carry"	"Carry"
"DOTA_Hero_Selection_PipTooltip_Disabler"	"Disabler"
"DOTA_Hero_Selection_PipTooltip_Initiator"	"Rumble Starter"
"DOTA_Hero_Selection_PipTooltip_Jungler"	"Jungler"
"DOTA_Hero_Selection_PipTooltip_Carry_Sub"	"Be better as th' battle drags on. That is, if they manage t' scrounge up sacks full o' coin."
"DOTA_Hero_Selection_PipTooltip_LaneSupport_Sub"	"Be kind 'nuff t' help early on, protectin' yer carry an' allowin' 'em t' farm in peace."
"DOTA_Hero_Selection_PipTooltip_Initiator_Sub"	"Good at startin' a crew brawl."
"loot_dropped"	"Loot Drop'd"
"DOTA_Chat_Bot_SuggestGlyph"	"Me thinks we should use th' Glyph"
"DOTA_Hero_Selection_PipTooltip_Pusher"	"Pusher"
"DOTA_Hero_Selection_PipTooltip_Support"	"Reinforcement"
"DOTA_Hero_Selection_PipTooltip_Support_Sub"	"Dun need sacks o' coin t' be useful. They be focused on usin' their abilities t' gain an advantage fer their crew."
"DOTA_Workshop_Error_CanGetQuota"	"Can't Get Steam Cloud Quota."
"DOTA_Workshop_Error_CouldntWriteFileToCloud"	"Couldn't write %s1 t' Steam Cloud."
"DOTA_GrabStashItems"	"Grab Stashed Loot"
"npc_dota_hero_undying"	"Undyin'"
"npc_dota_unit_tombstone1"	"Tombstone"
"npc_dota_unit_tombstone2"	"Tombstone"
"npc_dota_unit_tombstone3"	"Tombstone"
"npc_dota_unit_tombstone4"	"Tombstone"
"npc_dota_unit_undying_zombie"	"Undyin' Zombie"
"DOTA_Hero_Selection_ComboBox_Title_Role"	"By Role"
"DOTA_Hero_Selection_ComboBox_Title_Attack"	"By Attack type"
"DOTA_Hero_Selection_ComboBox_Title_ByMine"	"By Stats"
"DOTA_Hero_Selection_ComboBox_Title_Clear"	"Wipe Filter"
"DOTA_Hero_Selection_AdvFilter_Disabler"	"Disabler"
"DOTA_Hero_Selection_AdvFilter_LaneSupport"	"Lane Reinforcement"
"DOTA_Hero_Selection_AdvFilter_Jungler"	"Jungler"
"DOTA_Hero_Selection_Msg_Title"	"NARY AN ADMIRAL FOUND"
"DOTA_Hero_Selection_Msg_Desc_Base"	"Arr, nary an admiral matches th' filters ye've pick'd. Try gettin' rid o' one o' yer filters."
"DOTA_Hero_Selection_Msg_Desc_Suggestions"	"Here ye'd be able t' see admirals that other scallywags in yer crew suggest ye play as. That is, if any had been suggested. T' suggest an admiral t' th' other members o' yer crew, click on th' Suggest Admiral flag. Ye can suggest up t' two admirals at a time. No more, mate."
"DOTA_TeamMatchmake_Fail_Header"	"Crew Brawlfindin' Failed"
"DOTA_No_Courier"	"NARY A COURIER"
"DOTA_GoodGuysCaps"	"TH' RADIANT"
"DOTA_BadGuysCaps"	"TH' DIRE"
"npc_dota_hero_rubick"	"Rubick"
"DOTA_Hero_Selection_Btn_Suggest_On"	"ADVISE ADMIRAL"
"DOTA_Hero_Selection_Btn_Suggest_Off"	"UNADVISE ADMIRAL"
"dota_watch_live_tab"	"LIVE BATTLES"
"dota_watch_recent_tab"	"RECENT BATTLES"
"dota_no_live_games"	"Nary a Battle Underway"
"dota_no_live_games_desc"	"Arr, thar be no live battles bein' plunder'd at th' moment."
"dota_match_details_brief"	"DETAILS"
"DOTA_Matchmaking_Header"	"Brawlfindin'"
"DOTA_Matchmaking_Message"	"Avast! Two giant squids be attackin' th' harbor! Brawlfindin' an' practice lobbies be closed off 'til this be settled."
"dota_hud_error_cant_steal_spell"	"Can't rob this 'ere spell"
"DOTA_RP_PLAYING_OTHER"	"Plunderin' Other Adventure"
"DOTA_Chat_DropRateBonus"	"%s1 boosts th' <font color='#FFD700'>Battle Tallys</font> earned by all scallywags in this battle by <b><font color='#FFD700'>%s2%</font></b>!"
"npc_dota_hero_disruptor"	"Disruptor"
"npc_dota_hero_nyx_assassin"	"Nyx Assassin"
"DOTA_Hero_Selection_Filter_Disabler"	"DISABLER"
"DOTA_Hero_Selection_Filter_Jungler"	"JUNGLER"
"chat_join_channel"	"JOIN PARLEY CHANNEL"
"chat_create_channel"	"CRAFT NEW PARLEY CHANNEL"
"chat_create_channel_desc"	"Scribble in a custom channel title"
"chat_create_channel_button"	"CRAFT NEW CHANNEL"
"confirm_create_channel_button"	"ASSEMBLE"
"chat_custom_channels"	"CUSTOM"
"chat_regional_channels"	"SEAS"
"DOTA_InviteDenied_Header"	"Recruitment Denied"
"DOTA_InviteDenied_Message"	"Avast! Ye dun 'ave th' Cap'ns permission t' recruit scallywags an' craft a party."
"DOTA_PartyFull_Header"	"Party"
"DOTA_PartyFull_Message"	"Yer party be full."
"DOTA_RP_ACCOUNT_DISABLED"	"Brawlfindin' Turn'd Off fer a Moment"
"DOTA_PageUnavailable"	"Arr, We Be Under Siege By Giant Squids!"
"DOTA_PageUnavailableExplanation"	"Arr, we 'ave some men toilin' away t' fix this...<br>Why not queue up t' battle instead?"
"ItemTypeDesc"	"Level %s1 %s2"
"ItemTypeDescNoLevel"	"Level %s1"
"ItemTypeDescKillEaterAlt"	"%s2: %s1"
"ItemNameUniqueFormat"	"%s1%s2%s3"
"ItemNameWithQualityFormat"	"%s1 %s2%s3"
"ItemNameCraftNumberFormat"	" #%s1"
"TF_Tag_Category_Misc"	""
"TF_Tag_Category_Quality"	"Quality"
"TF_Tag_Category_Class"	"Class"
"TF_Tag_Category_Type"	"Kind"
"DOTA_Tag_Category_Hero"	"Admiral"
"Tag_Category_Rarity"	"Rarity"
"DOTA_Game_Modifier"	"! Game Modifier"
"DOTA_OtherType"	"Other"
"EconNotificationsCount"	"x%s1"
"DOTA_EconNotification_Header"	"Notification"
"Econ_Store"	"MARKET"
"Econ_Loadout"	"ARMORY"
"Econ_Workshop"	"WORKSHOP"
"DOTA_View"	"See"
"DOTA_Ignore"	"Ignore"
"DOTA_HasNewItems_Title"	"Ye got new items!"
"DOTA_BackpackDelete"	"Purge"
"DOTA_BackpackDiscard"	"Toss Overboard"
"DOTA_BackpackNoAction"	"Can't Be Used"
"DOTA_TreasureCache_Type"	"Treasure"
"DOTA_TreasureCache_Desc"	"Ye be needin' a Treasure Key t' open this. Ye can pick one up at the DOTA 2 Market."
"DOTA_Tool_TreasureKey"	"Treasure Key"
"ExpandUse"	"Expand"
"UnlockUse"	"Unlock"
"GiftUse"	"Parcel"
"ToolActionCancel"	"Belay"
"UsingTool"	"Usin' %s1 on %s2."
"ToolUseReminder"	"Remember, bucko, once you've used a tool, it's gone fer good!"
"RenameTool_CurrentName"	"Current Title o' Booty: %s1"
"RenameTool_NewName"	"New Loot Title:"
"RenameTool_Confirm"	"Sure ye wanna rename th' booty t'...'%s1'? Really?"
"RenameTool_Invalid"	"Titles can't be havin' leadin' or trailin' spaces."
"DescTool_CurrentDesc"	"Current Description: %s1"
"DescTool_NewDesc"	"New Description:"
"DescTool_Invalid"	"Oi, descriptions can't 'ave any leadin' or trailin' spaces, ye git."
"DOTA_UseFail_NotInGame"	"Ye 'ave t' be in a battle an' jab yer 'action item' key t' use this."
"DOTA_Gift_Confirm"	"Arr, sure ye wish t' use th' loot found in th' parcel?"
"DOTA_NewItem"	"Arr, New Loot Plunder'd!"
"DOTA_GiftedItems"	"%s1 'as given a parcel t' %s2!"
"DOTA_GifterText_Random"	"%recipient% was chosen t' receive a parcel by a random drunk named %giver%!"
"DOTA_GifterText_All"	"%giver% be hammer'd like a floorboard an' threw parcels ev'rywhere!"
"DOTA_GifterText_SelfOpen"	"%giver% 'as open'd a package!"
"DOTA_GifterText_Title"	"Parcels ev'rywhere!"
"DOTA_UseItem_MiniGameAlreadyStarted"	"Avast! That minigame is already underway."
"DOTA_UseItem_Success"	"Ye used th' loot successfully!"
"DOTA_UseItem_Error"	"Avast! Ye can't seem t' use this 'ere piece o' loot. Perhaps ye jus' dun meet th' requirements, or perhaps ye ain't drunk enough."
"DOTA_UseItem_GiftNoPlayers"	"Avast! Ye be alone as thar be no other scallywags t' give th' parcel t'. Ferever alone at sea."
"DOTA_UseItemNotification_ButtonOne"	"AYE"
"DOTA_UseItemNotification_ButtonTwo"	"Ignore"
"DOTA_UseItem_NotInLowPriorityPool"	"Avast! Ye ain't in no low priority punishment queue! Yer Repentant Soul 'asn't been used."
"Econ_Crate_Locks_Remaining"	"Number o' locks remainin': %s1"
"AddToCollection"	"Collect Loot"
"WrapGift"	"Wrap Parcel"
"UnwrapGift"	"Unwrap Parcel"
"DeliverGift"	"Deliver Parcel"
"DOTA_AnyHero"	"Any Admiral"
"DOTA_NoSlot"	"N/A"
"base"	"Base"
"community"	"Crew"
"developer"	"Valve"
"selfmade"	"Me Own"
"genuine"	"Authentic"
"unusual"	"Special"
"tool_type_none"	"None"
"tool_type_hero_taunt"	"Admiral Mock"
"tool_type_name"	"Title Tag"
"IT_MDL_Files"	"MDL Files (*.mdl)"
"IT_TestingFiles"	"Testin' Files (*.itf)"
"TestItemCustomizeMDLTitle"	"Choose custom mdl..."
"TestItemSaveSetupTitle"	"Export test loot setup..."
"TestItemLoadSetupTitle"	"Import test loot setup..."
"DOTA_DeleteItemConfirmText_Recycle"	"Throw it o'erboard? Once it be over port side, it'll be lost t' the sea. An' ye can't doubleback on yer word. Aye, but when ye toss %s1 o'er, our boys sometimes find one %s2, usually somethin' that fell off o' it."
"DOTA_DeleteItemConfirmText_UltraRare"	"Throw it o'erboard? Once it be over port side, it'll be lost t' the sea. An' ye can't doubleback on yer word.<i><b><font color='#FF2222'> Avast, me hearty! This be some valuable booty!</font></b></i> Thar be no chance o' findin' somethin' new when this be tossed o'er!"
"DOTA_PlayerLoadout"	"Scallywag Armory"
"DOTA_CustomizePlayerLoadout"	"Customize Scallywag Armory"
"DOTA_DropRateModifiersNone"	"Ye're currently receivin' <font color='#FFD700'>Battle Tallies</font> at th' base rate. Battle Tallies're earned each time ye complete a game through matchmakin'. Ye'll earn free loot every time yer <font color='#FFD700'>Battle Rank</font> increases. There're a wide range o' loot that add t' th' rate at which ye earn Battle Tallies."
"DOTA_DropRateModifiers"	"Battle Tallies Modifiers:"
"DOTA_DropRateModifier_Bonus"	"Current Rate: <font color='#FFFFFF'>%s1</font>"
"LoadoutSlot_Weapon"	"Weapon"
"LoadoutSlot_Head"	"Skull"
"LoadoutSlot_Shoulder"	"Shoulder"
"LoadoutSlot_Arms"	"Arms"
"LoadoutSlot_Armor"	"Armor"
"LoadoutSlot_Belt"	"Belt"
"LoadoutSlot_Back"	"Back"
"LoadoutSlot_Neck"	"Neck"
"LoadoutSlot_Legs"	"Leggings"
"LoadoutSlot_Gloves"	"Gloves"
"LoadoutSlot_Taunt"	"Mock"
"LoadoutSlot_Courier"	"Courier"
"LoadoutSlot_Announcer"	"Announcer"
"LoadoutSlot_Mega_Kills"	"Mega-Kill Announcer"
"LoadoutSlot_Action_Item"	"Funny Trinket"
"LoadoutSlot_Ability_Attack"	"Default Invade"
"LoadoutSlot_Ability1"	"Skill 1"
"LoadoutSlot_Ability2"	"Skill 2"
"LoadoutSlot_Ability3"	"Skill 3"
"LoadoutSlot_Ability4"	"Skill 4"
"LoadoutSlot_Ability_Ultimate"	"Ultimate"
"LoadoutSlot_Body_Head"	"Body - Skull"
"LoadoutSlot_Custom_Hex"	"Hex Effects"
"TF_Style_Desc"	"Style: %s1"
"DOTA_Item_Unnamed_New_Item"	"Untitled New Loot"
"DOTA_Loadout_SelectHero"	"Choose an Admiral"
"Store_New_Items"	"New!"
"Store_Gear"	"Booty"
"Store_Tools"	"Tools"
"Store_Taunts"	"Mocks"
"Store_Effects"	"Effects"
"Store_Abilities"	"Skills"
"Store_Featured"	"Highlighted"
"Store_Announcers"	"Announcers"
"Store_Couriers"	"Couriers"
"Store_ViewCart"	"See Rowboat"
"Store_Loadout"	"Armory"
"Attrib_ExpirationDate"	"This piece o' loot will be rotten an' useless on %s1."
"AttribFormat_AdditionalNote"	"( %s1 )"
"Attrib_CollectionReward"	"Collection Reward"
"Attrib_PreviewItem"	"Test Run - Cannot be barter'd, craft'd, or engraved."
"Attrib_Always_Tradable"	"Can Always Be Bartered"
"Attrib_ItemFind_Positive"	"Scavenger: %s1% boost in th' chance o' findin' some loot fer this 'ere admiral while adventurin'. Jus' be sure t' keep it equipped on ye."
"Attrib_AttachedParticle"	"Effect: %s1"
"Attrib_SetItemTintRGB"	"Color: %s1"
"Attrib_Particle15"	"Ethereal Flame"
"Attrib_Particle16"	"Resonant Energy"
"Attrib_Particle17"	"Watchful Eye"
"Attrib_Particle18"	"Searin' Essence"
"Attrib_Particle19"	"Burnin' Animus"
"Attrib_Particle20"	"Piercin' Beams"
"Rarity_Common"	"Common"
"Rarity_Uncommon"	"Uncommon"
"Rarity_Rare"	"Rare"
"Rarity_Mythical"	"Mythical"
"Rarity_Legendary"	"Storied"
"Rarity_Ancient"	"Ancient"
"Rarity_Immortal"	"Timeless"
"RarityTypeDesc"	"%s1 %s2"
"Unknown_Item_Type"	"Piece o' Loot"
"DOTA_Chat_EconItem"	"%s1 'as been awarded wit' %s2!"
"Econ_Bundle_Double"	"%s1, %s2"
"Econ_Bundle_DoubleContinued"	"%s1, %s2,"
"KillEaterEventType_Kills"	"Murders"
"KillEaterEventType_KillAssists"	"Murder Assists"
"KillEaterEventType_Wins"	"Victories"
"KillEaterEventType_Treants_Created"	"Treants Created"
"KillEaterEventType_Omnislash_Jumps"	"Omnislash Jumps"
"KillEaterEventType_Blade_Fury_Time"	"Blade Fury Damage"
"KillEaterEventType_Blade_Dance_Crits"	"Blade Dance Crits"
"KillEaterEventType_Wards_Placed"	"Wards Placed"
"KillEaterEventType_Killing_Sprees"	"Killin' Sprees"
"KillEaterEventType_Horrors_Witnessed"	"Horrors Witness'd"
"KillEaterEventType_Carries_Killed"	"Carries Kill'd"
"KillEaterEventType_First_Blood"	"First Bloods"
"KillEaterEventType_Godlike"	"Godlike Sprees"
"KillEaterEventType_Trees_Created"	"Trees Created"
"KillEaterEventType_Gold_Earned"	"Coin Earn'd"
"KillEaterEventType_Gold_Spent"	"Coin Spent"
"KillEaterEventType_Towers_Destroyed"	"Towers Wreck'd"
"KillEaterRank1"	"Unremarkable"
"KillEaterRank2"	"Blood'd"
"KillEaterRank3"	"Menacin'"
"KillEaterRank4"	"Uncharitable"
"KillEaterRank5"	"Dangerous"
"KillEaterRank6"	"Notably Dangerous"
"KillEaterRank7"	"Lethal"
"KillEaterRank8"	"Spectacularly Lethal"
"KillEaterRank9"	"Blood-Drench'd"
"KillEaterRank10"	"Gore-Spatter'd"
"KillEaterRank13"	"Face-Meltin'"
"KillEaterRank14"	"Rage-Inducin'"
"KillEaterRank15"	"Match-Endin'"
"KillEaterRank16"	"Dishonorable"
"KillEaterRank17"	"Utterly Broken"
"WinsRank1"	"Newbie"
"WinsRank2"	"Deckhand"
"WinsRank3"	"Apprentice"
"WinsRank4"	"Journeyman"
"WinsRank5"	"Sea-Hardened Cap'n"
"WinsRank6"	"Davy Jones 'imself"
"WinsRank7"	"Grand Master"
"WinsRank8"	"Authority"
"WinsRank9"	"Virtuoso"
"WinsRank10"	"Single-Mind'd"
"WinsRank11"	"Try-Hard"
"WinsRank12"	"Die-Hard"
"WinsRank13"	"Goin' Pro"
"WinsRank14"	"Almost Pro"
"WinsRank15"	"Pure Pro"
"WinsRank16"	"Win Machine"
"FurionRank1"	"Seedlin'"
"FurionRank2"	"Sproutlin'"
"FurionRank3"	"Twiggy"
"FurionRank4"	"Leafy"
"FurionRank5"	"Frondly"
"FurionRank6"	"Verdant"
"FurionRank7"	"Lush"
"FurionRank8"	"Flourishin'"
"FurionRank9"	"Bountiful"
"FurionRank11"	"Magnificent"
"FurionRank12"	"Consecrated"
"FurionRank13"	"Enshrined"
"FurionRank14"	"Verodicia's Own"
"JuggernautRank1"	"Fergotten"
"JuggernautRank2"	"Derelict"
"JuggernautRank3"	"Outcast"
"JuggernautRank4"	"Notable"
"JuggernautRank5"	"Accomplish'd"
"JuggernautRank6"	"Experience'd"
"JuggernautRank7"	"Unchallenged"
"JuggernautRank8"	"Undefeatable"
"JuggernautRank9"	"Unconquer'd"
"JuggernautRank11"	"Renown'd"
"JuggernautRank12"	"Storied"
"JuggernautRank13"	"Celebrated"
"JuggernautRank14"	"Immortal"
"TowersRank1"	"Impair'd"
"TowersRank2"	"Impairin'"
"TowersRank3"	"Vandalizin'"
"TowersRank4"	"Ravagin'"
"TowersRank5"	"Razin'"
"TowersRank6"	"Wreckin'"
"TowersRank7"	"Decimatin'"
"TowersRank8"	"Demolishin'"
"TowersRank9"	"Disintigratin'"
"TowersRank10"	"Pulverizin'"
"TowersRank11"	"Atomizin'"
"TowersRank12"	"Planckifyin'"
"TowersRank13"	"Steeple Topplin'"
"TowersRank14"	"Monolith Mashin'"
"TowersRank15"	"Edifice Defyin'"
"TowersRank16"	"Tower-Bane"
"ItemSet"	"Set: %s1"
"RefurbishItem_RemovePaintTitle"	"Purge Paint?"
"RefurbishItem_RemovePaint"	"Purge th' custom color fro' this treasure, restorin' th' original color?\n\n(Th' can o' paint will be tossed overboard)"
"RefurbishItem_RemoveCustomTextureTitle"	"Purge Yer Mark?"
"RefurbishItem_RemoveCustomTexture"	"Purge th' banner n' colors applied to this loot?"
"RefurbishItem_RemoveCraftIndexTitle"	"Purge Craft Number?"
"RefurbishItem_RemoveCraftIndex"	"Purge th' craft number from this piece o' loot?"
"RefurbishItem_RemoveMakersMarkTitle"	"Purge Crafter Title?"
"RefurbishItem_RemoveMakersMark"	"Purge th' crafter's title from this loot?"
"RefurbishItem_Yes"	"Aye, Wipe It"
"RefurbishItem_No"	"Nay, Leave It"
"NewItemMethod_Crafted"	"Ye Crafted:"
"NewItemMethod_Traded"	"Ye Barter'd fer:"
"NewItemMethod_Gifted"	"Ye Received a Parcel:"
"NewItemMethod_Promotion"	"Ye Received some Promotional Market Loot:"
"NewItemMethod_Earned"	"Ye Earn'd:"
"NewItemMethod_Refunded"	"Ye Got Back:"
"NewItemMethod_Support"	"Customer Support Gave Ye:"
"NewItemMethod_CollectionReward"	"Ye Redeemed some Special Collection Loot:"
"NewItemMethod_PreviewItem"	"Ye be Playin' wit:"
"NewItemMethod_PreviewItemPurchased"	"Ye Acquired:"
"NewItemMethod_PeriodicScoreReward"	"Ye Earn'd:"
"Item_Found"	"Scallywag %s1 'as earn'd: <font color='%s2'>%s3</font> %s4"
"Item_Crafted"	"%s1 'as forged: <font color='%s2'>%s3</font> %s4"
"Item_Traded"	"%s1 bartered fer: <font color='%s2'>%s3</font> %s4"
"Item_Purchased"	"%s1 acquired: <font color='%s2'>%s3</font> %s4"
"Item_FoundInCrate"	"%s1 'as unboxed: <font color='%s2'>%s3</font> %s4"
"Item_Gifted"	"%s1 received a parcel: <font color='%s2'>%s3</font> %s4"
"Item_Earned"	"%s1 earned: <font color='%s2'>%s3</font> %s4"
"Item_Refunded"	"%s1 got back: <font color='%s2'>%s3</font> %s4"
"Item_GiftWrapped"	"%s1 'as prepared a parcel: <font color='%s2'>%s3</font> %s4"
"Item_CollectionReward"	"%s1 'as redeemed somethin' special: <font color='%s2'>%s3</font> %s4"
"Item_PeriodicScoreReward"	"%s1 earned: <font color='%s2'>%s3</font> %s4"
"dota_killcam_generic_damage"	"Damage"
"dota_killcam_generic_damage_subtitle"	"Close or ranged attacks"
"npc_dota_hero_naga_siren"	"Naga Siren"
"npc_dota_hero_keeper_of_the_light"	"Keeper o' th' Light"
"DOTA_Hero_Selection_AdvFilter_Durable"	"Tough"
"DOTA_Hero_Selection_AdvFilter_Nuker"	"Nuker"
"DOTA_Hero_Selection_AdvFilter_Escape"	"Escape"
"DOTA_Hero_Selection_Filter_LaneSupport"	"LANE REINFORCEMENT"
"DOTA_Hero_Selection_Filter_Durable"	"TOUGH"
"DOTA_Hero_Selection_Filter_Nuker"	"NUKER"
"DOTA_Hero_Selection_Filter_Escape"	"ESCAPE"
"DOTA_Hero_Selection_PipTooltip_LaneSupport"	"Lane Reinforcements"
"DOTA_Hero_Selection_PipTooltip_Durable"	"Tough"
"DOTA_Hero_Selection_PipTooltip_Nuker"	"Nuker"
"DOTA_Hero_Selection_PipTooltip_Escape"	"Escape"
"DOTA_Hero_Selection_PipTooltip_Escape_Sub"	"Has th' ability t' flee from a fight they can't win."
"DOTA_Hero_Selection_Spin_Random_Hero"	"BLIND PICK"
"dota_quit_button"	"ABANDON SHIP"
"dota_hud_error_only_deliberate_channel_cancel"	"Arr, be usin' a specific kind o' command t' stop th' channel"
"DOTA_BackpackEquip"	"Equip"
"DOTA_BackpackEquipHero"	"Equip %s1"
"DOTA_BATTLE_POINTS"	"Battle Tallies"
"DOTA_Scoreboard_Header_Battle_Level"	"RANK"
"DOTA_Lobby_UserMenu_BotPassive"	"Dummy - Passive"
"DOTA_Lobby_UserMenu_BotEasy"	"Dummy - Landlubber"
"DOTA_Lobby_UserMenu_BotMedium"	"Dummy - Swashbuckler"
"DOTA_Lobby_UserMenu_BotHard"	"Dummy - Sea-Harden'd"
"DOTA_Lobby_UserMenu_BotUnfair"	"Dummy - Unfair"
"DOTA_Community_CreateTeamCaps"	"ASSEMBLE CREW"
"Team_Create_Header"	"CREWS"
"Team_Create_Full_Name"	"Full Crew Title"
"Team_Create_Tag"	"Crew Tag/Abbreviation"
"Team_Create_Logo"	"Hoist Up Crew Flags"
"Team_Browse_Logo"	"Crew Interface Flag. This flag will be used in th' HUD, lobbies, and so on. It will be resized t' 250 x 150 pixels."
"Team_Members_Header"	"CREWMATES"
"Team_Invitation"	"CREW RECRUIT"
"DOTA_UI_Browse"	"SCOUR"
"DOTA_Hero_Selection_Suggest_Title"	"Admiral Suggestions"
"DOTA_Hero_Selection_Suggest_Text"	"Here ye can look at admirals suggested by yer crew. Ye can suggest a hero to yer crew by jabbin' on th' Suggest button on th' Admiral's card."
"DOTA_Hero_Selection_Suggest_Hero_Title"	"%s1"
"DOTA_Hero_Selection_Suggest_Hero_Text1"	"Suggested by: %s1"
"DOTA_Hero_Selection_Suggest_Hero_Text2"	"Suggested by: %s1, an' %s2"
"DOTA_Hero_Selection_Suggest_Hero_Text3"	"Suggested by: %s1, %s2, an' %s3"
"DOTA_Hero_Selection_Suggest_Hero_Text4"	"Suggested by: %s1, %s2, %s3, an' %s4"
"DOTA_Hero_Selection_Suggest_Hero_Text5"	"Suggested by: %s1, %s2, %s3, %s4, an' %s5"
"DOTA_Hero_Selection_TT_Random_Title"	"Blind Pick"
"DOTA_Hero_Selection_TT_Repick_Title"	"Repick yer Admiral"
"DOTA_Hero_Selection_TT_Repick_Text"	"Turn 'round an' pick another admiral. Ye forfeit 100 o' yer startin' gold, an' ye lose any extra bit o' gold ye earn'd by randomin'. Ye may only repick one per game."
"DOTA_Hero_Selection_TT_Suggest_Title"	"Suggest Admiral"
"DOTA_Hero_Selection_TT_Suggest_Text"	"Tell yer crew that ye think this admiral would be a good choice. Ye can suggest only 2 admirals at a time."
"DOTA_Hero_Selection_TT_Favorite_Title"	"Favored Admiral"
"DOTA_Hero_Selection_RD_Soon"	"Arr, yer turn be comin' up soon."
"DOTA_Hero_Selection_RD_Next"	"Ye be pickin' next!"
"DOTA_Hero_Selection_Suggest"	"Admiral"
"DOTA_Hero_Selection_Intro_Header"	"ELECT AN ADMIRAL"
"DOTA_Hero_Selection_Intro_Body"	"Look through th' admirals usin' yer mouse or th' arrow keys.\n\nMake yer way o'er t' th' admiral by scribblin' their name. \n\nJab ALT + Enter t' easily confirm yer choice.\n\nUse th' filters t' make choosin' yer role easier."
"dota_dashboard_category_team"	"CREW"
"matchmaking_difficulty_label"	"SEVERITY"
"dota_prfile_wins_hero"	"W"
"dota_prfile_losses_hero"	"L"
"dota_prfile_game_needed"	"Ye need %s1 more battle"
"dota_prfile_games_needed"	"%s1 more battles be needed"
"DOTA_TeamLogo_Error_Header"	"Avast! Fail'd t' amend th' flag"
"DOTA_TeamLogo_Error_Unspecified"	"Avast! Somethin' bungled while amendin' yer crew's flag. Go an' try again."
"UI_difficulty_label"	"SEVERITY"
"UI_difficulty_command"	"ELECT SEVERITY"
"DOTA_RP_SPECTATING_WHILE_FINDING"	"Lookin' Fer A Battle & Lookin' Out"
"DOTA_KillEaterLevel_Text"	"Ya-har! Yer %s1 'as increased in rank! It be now %s2!"
"DOTA_KillEaterLevel_Title"	"Yer loot 'as gain'd a rank!"
"DOTA_Event_KillEater_Leveled_Chat"	"%s1's <font color='#FFD700'>%s2</font> 'as reach'd a new rank: <font color='#FFD700'>%s3</font>!"
"DOTA_LeagueViewPass"	"Use this tourney?"
"DOTA_LeagueViewPassEnabled"	"Tourney Activated! Ye can find it under th' Watch/Tourney's tab."
"DOTA_Hero_Selection_AllHeroes"	"SHOW ALL ADMIRALS"
"npc_dota_hero_visage"	"Visage"
"npc_dota_visage_familiar1"	"Familiar"
"npc_dota_visage_familiar2"	"Familiar"
"npc_dota_visage_familiar3"	"Familiar"
"DOTA_Lobby_Spectator_Type"	"LOOKOUTS"
"DOTA_Lobby_Spectator_Enabled"	"Turned On"
"DOTA_Lobby_Spectator_Disabled"	"Turned Off"
"DOTA_HS_FilterBy"	"FILTER BY"
"DOTA_HS_CurrentlyEquipped"	"CUSTOMIZE %s1"
"DOTA_HS_SelectEquip"	"PICK SOME LOOT T' EQUIP"
"DOTA_HS_UnEquip"	"UNEQUIP"
"DOTA_HS_NoItems_Title"	"THAR BE NO LOOT FER THIS FELLA (YET)"
"DOTA_HS_NoItems_Desc"	"Arr, we haven't released any fancy lookin' loot fer this admiral yet. If ye'd like t' concoct some o' yer own, head over t' th' Dota Workshop t' submit 'em."
"dota_dashboard_category_customize"	"MARKET"
"dota_watch_subscriptions_tab"	"TOURNEYS"
"today_news_tab"	"TIDINGS"
"DOTA_Workshop_Error_JPEG_FileFormat"	"Avast! Preview File be in th' wrong format. Use RGB or YCbCr."
"DOTA_BackpackEquipLoadout"	"Equip Yer Armory"
"DOTA_BackpackUse"	"Use"
"OpenPack"	"Open Up Pack"
"LoadoutSlot_OffHand_Weapon"	"Off-Hand"
"Store_DOTA_Access"	"DOTA 2 Access"
"Attrib_Particle21"	"Felicity's Blessin'"
"Attrib_Particle22"	"Angry Bats"
"RefurbishItem_RemovePaintOption"	"Purge Paint"
"RefurbishItem_RemoveNameOption"	"Purge Title"
"RefurbishItem_RemoveDescOption"	"Purge Description"
"RefurbishItem_RemoveCustomTextureOption"	"Purge Decal"
"RefurbishItem_RemoveCraftIndexOption"	"Strip Craft Number From Loot"
"RefurbishItem_RemoveMakersMarkOption"	"Strip Crafter Title From Loot"
"CopyToClipboard"	"Copy t' Clipboard"
"ent_dota_halloffame"	"Aegis o' Champions"
"npc_dota_gyrocopter_homing_missile"	"Homin' Missile"
"Tournament_dropdown"	"Filter by Tourney"
"Tournament_None"	"None"
"Tournament_WestQualifier"	"West Qualifier"
"Tournament_EastQualifier"	"East Qualifier"
"DOTA_EventTicketEnabled"	"Ya-har, ye've been registered! Ye'll get an email within' a week or two wit' further instructions."
"DOTA_InternationalTicketButton"	"Ye did it! Break out th' rum!"
"DOTA_InternationalTicketButton_Desc"	"Ye be all set an' confirmed proper fer Th' International.\nYe can request yer passport information be sent yer way through th' email account that be link'd wit' yer Steam ship by jabbin' down below."
"Store_International"	"International"
"DOTA_Tooltip_Ultimate_Upgrade"	"UPGRADES: "
"npc_dota_hero_wisp"	"Io"
"DOTA_Hero_Selection_Layout_Edit_Title"	"Amend Layout"
"DOTA_Hero_Selection_Layout_Save_Title"	"Archive Amendin's"
"DOTA_Hero_Selection_Layout_Cancel_Title"	"Toss Amendments"
"DOTA_Hero_Selection_Layout_Reset_Title"	"Reset T' th' Usual"
"DOTA_Hero_Selection_Layout_Import_Title"	"Bring In Layout"
"DOTA_Hero_Selection_Layout_Export_Title"	"Cast Off Layout"
"DOTA_Hero_Selection_Layout_Import_Text"	"Fetch a layout from a file. Layouts need t' be set in yer dota/cfg/layouts section t' appear in th' import list."
"DOTA_Hero_Selection_Layout_Export_Text"	"Export yer layout t' a file. Yer layout be archived automatically in th' Steam Cloud, but ye'll need t' use this t' export it if ye want t' share wit' yer mateys. Exported layouts be written t' yer dota/cfg/layouts directory."
"DOTA_Hero_Selection_Export"	"Enter Filename"
"DOTA_Hero_Selection_Export_Succeeded"	"Layout Export'd"
"DOTA_Hero_Selection_Import"	"Choose yer Layout"
"DOTA_Hero_Selection_Import_Failed"	"Arr, Import Fail'd"
"DOTA_Hero_Selection_Import_Succeeded"	"Layout Import'd"
"DOTA_Hero_Selection_BackToBrowsing_Title"	"Return"
"DOTA_Hero_Selection_BackToLoadout_Title"	"Return"
"DOTA_UserMenu_Inspect"	"Inspect Admiral"
"DOTA_DeleteItemConfirmText"	"Toss overboard? Throw this 'ere loot o'er an' ye'll never get it back, Cap'n."
"DOTA_Shop_Search_Results_Title"	"SCOURIN' RESULTS"
"DOTA_Shop_Category_Basics"	"TH' ROPES"
"DOTA_Shop_Category_Upgrades"	"UPGRADES"
"Dota_Shop_view"	"See"
"Dota_Shop_Save_Success"	"Archived Successfully"
"Dota_Shop_Save_Title"	"Archive Build"
"Dota_Shop_Load"	"Fetch Build"
"Dota_Shop_Edit"	"Amend Mode"
"DOTA_Announcer_Select_Title"	"PICK AN ANNOUNCER"
"DOTA_Announcer_Default"	"Th' Usual Announcer"
"Team_Create_Full_Name_Desc"	"This'll be shown in yer crew's log."
"Team_Create_Tag_Desc"	"This'll be shown in lobbies, tallyboards, an' th' pillagin' HUD."
"Team_Browse_Base_Logo"	"Crew Base Flag. This flag will be used t' decorate yer base. It will be resized t' 256 x 256 pixels."
"Team_Browse_Banner_Logo"	"Crew Banner Flag. This flag will be placed on yer banners. It will be resized to 256 x 256 pixels, with the' front of th' banner in th' left half o' th' image, and th' rear in th' right."
"Team_No_Logo"	"NO FLAG SPECIFIED"
"replay_download_failed"	"ARR, FAIL'D T' RECEIVE REPLAY"
"replay_download_fail_code"	"Download Error: %s1"
"replay_download_open_failed"	"Couldn't open t' replay file, Cap'n. Make sure ye dun 'ave any other processes 'ave this 'ere file open."
"replay_download_create_failed"	"Avast! Could nah craft th' replay file o' specified size. Shiver me timbers, clean out yer storage!"
"replay_download_request_fail"	"Fail'd t' cast request fer part o' th' file."
"replay_download_handle_fail"	"Arr, we can't find th' bleedin' file handle."
"replay_download_chunk_not_found"	"Can't seem t' find th' file chunk in th' receivin' list."
"replay_download_write_failed"	"We ain't literate 'nuff t' write t' a replay file!"
"replay_download_data_failed"	"Arr, fail'd t' snatch data from th' receiver buffer."
"replay_download_decompress_failed"	"Could nah decompress replay file. Go an' try gettin' th' replay again."
"missing_league_subscription"	"Avast! This be a league battle that requires a subscription t' see. Off wit' ye, sprog!"
"DOTA_StrangePart_Confirm"	"Sure ye wish t' attach this 'ere strange modifier t' yer loot?"
"DOTA_Subscription_Teams"	"Crews"
"DOTA_Subscription_TeamsVS"	"%s1  VS  %s2"
"DOTA_Subscription_Website"	"Tourney Website"
"Store_Tournaments"	"Tourneys"
"DOTA_Workshop_BrowseImage"	"Th' paintin' preview will be cut down t' 512 x 512 when show across th' 7 Seas."
"DOTA_Workshop_PreviewTitle"	"PREVIEW PICTURE:"
"DOTA_Workshop_ItemTitle"	"TITLE:"
"DOTA_Workshop_HeroTitle"	"ADMIRAL:"
"DOTA_Workshop_SlotTitle"	"ARMORY SLOT:"
"DOTA_Workshop_TypeTitle"	"TYPE O' LOOT:"
"DOTA_Workshop_FileTitle"	"SUBMISSION FILE:"
"DOTA_Workshop_DescTitle"	"DESCRIPTION:"
"DOTA_Workshop_TestTitle"	"IMPORT MODEL"
"DOTA_Workshop_SubmitTitle"	"CAST OFF T' TH' WORKSHOP"
"DOTA_Workshop_Test"	"TEST"
"DOTA_Workshop_TestExplanation"	"Wearables need t' be tested t' make sure they're within th' budget. Pick th' compiled model an' then jab th' Test button. If yer submittin' somethin' other than a wearable, ye can skip this step! Submissions o' untest'd wearable models won't be consider'd fer addition int' Dota 2."
"DOTA_Workshop_NoFile"	"< NO FILE CHOSEN >"
"DOTA_Workshop_ValidationFailed"	"Validation fail'd. Loot can't be submitt'd."
"DOTA_Workshop_ValidationSucceeded"	"Validation succeeded, yahar!"
"DOTA_Workshop_File_Submission"	"Submissions (.zip files)"
"DOTA_Workshop_File_Preview"	"Preview Paintin's (.jpg files)"
"DOTA_Workshop_File_Models"	"Models (.mdl files)"
"DOTA_Workshop_NoHeroSelected"	"Pick an admiral"
"DOTA_BackpackPreview"	"Preview"
"DOTA_UnusualPaint_Confirm"	"Really sure ye wish t' give yer Unusual loot <font color='#%s1'>this color</font>? Th' original will be replaced. Ye can't doubleback on this!"
"LoadoutSlot_Mount"	"Mount"
"npc_dota_hero_slark"	"Slark"
"npc_dota_unit_undying_zombie_torso"	"Undyin' Zombie"
"Inventory_Default_Courier"	"Usual Courier"
"DOTA_Inventory_Courier_Purchaser"	"Owned By: %s1"
"DOTA_Lobby_UserMenu_ApplyTeam"	"Apply me crew t' this 'ere lobby"
"dota_matchgroup_ru"	"Russia"
"DOTA_ToolTip_Aghanim"	"Upgradable by Aghanim's Scepter."
"hero_showcase_title"	"FEATURED ADMIRAL"
"hero_showcase_change"	"CHANGE ADMIRAL"
"hero_showcase_show_in_profile"	"Use this admiral in me log"
"UI_skill_any"	"Any"
"UI_skill_normal"	"Normal"
"UI_skill_high"	"High"
"UI_skill_very_high"	"Sea-Hardened"
"DOTA_Subscription_Match"	"Match"
"DOTA_Subscription_Time"	"Time"
"DOTA_Subscription_Rating"	"Ratin'"
"DOTA_Subscription_Viewers"	"On-lookers"
"DOTA_Partial_Team"	"Partial Crew Used"
"DOTA_LocalPlayer"	"Local Scallywag"
"DOTA_Inspect_Battle_Points_Rate"	"Battle Tallies Rate: %s1"
"dota_gameend_xp_awarded"	"+%s1 Tallies"
"DOTA_Unpausing"	"Returnin' t' battle"
"DOTA_RP_CASTING"	"Castin' A Battle"
"DOTA_Workshop_File_Texture"	"Texture (.tga files)"
"DOTA_Workshop_HeroSelect"	"Choose Admiral"
"DOTA_Workshop_SlotSelect"	"Choose slot"
"DOTA_ItemTest_Required"	"Required"
"DOTA_ItemTest_Required_Texture"	"Required (Textures'll be cut down t': %s1)"
"DOTA_ItemTest_NotRequired_Texture"	"(Textures'll be cut down t': %s1)"
"DOTA_ItemTest_ItemName"	"OUTPUT FILE TITLE:"
"DOTA_ItemTest_ItemName_Desc"	"This be th' output file title fer yer loot. It can't be seen by other scallywags, an' needs t' be less than 50 scribbles."
"DOTA_ItemTest_LOD0Title"	"OPTIONAL PORTRAIT GEOMETRY"
"DOTA_ItemTest_LOD1Title"	"GEOMETRY IN BATTLE"
"DOTA_ItemTest_Texture_Desc"	"Arr, this be a set o' four .TGA files that be mergin' t' texture this 'ere geometry file. Scour an' pick th' _color, _normal, _mask1, or _mask2 .TGA files, an' we'll be lookin' 'round fer th' rest!"
"DOTA_ItemTest_Texturing"	"Texturin' Aid"
"DOTA_ItemTest_Modelling"	"Modellin' Aid"
"DOTA_ItemTest_ImportError"	"Texture File Errarrrrr!"
"DOTA_ItemTest_Error_TextureNameA"	"Arr, can nah recognize th' chosen .TGA file title! Textures 'ave t' end wit' one o' th' followin' suffixes:  _color, _normal, _mask1, _mask2"
"DOTA_ItemTest_Error_TextureNameB"	"Avast! Can't be findin' a matchin' .TGA file wit' this 'ere suffix:\n %s1"
"DOTA_InternationalTicketButton1"	"Request Email"
"DOTA_InternationalTicketButton2"	"Done"
"DOTA_LeagueNoOwnership"	"Arr, No Tournament Access"
"DOTA_NoHero"	"N/A"
"LoadoutSlot_None"	"N/A"
"LoadoutSlot_Misc"	"Misc"
"Attrib_Particle31"	"Triumph o' Champions"
"Attrib_Particle32"	"Sunfire"
"KillEaterEventType_Bounty_TrackedKills"	"Track'd Kills"
"KillEaterEventType_Bounty_TrackedInvisKills"	"Track'd Invisible Kills"
"KillEaterEventType_Bounty_InvisJinadaHits"	"Invisible Jinada Strikes"
"KillEaterEventType_Bounty_TrackGold"	"Track'd Bonus Coin"
"KillEaterEventType_Tide_GoodRavages"	"Quad Ravages"
"KillEaterEventType_Windrunner_DoubleShackles"	"Double Shackles"
"KillEaterEventType_Windrunner_GoodPowershots"	"Multi-Admiral Powershots"
"KillEaterEventType_Invoker_SunstrikeKills"	"Sunstrike Kills"
"KillEaterEventType_Couriers_Purchased"	"Couriers Acquired"
"KillEaterEventType_Wards_Purchased"	"Wards Acquired"
"KillEaterEventType_Tide_EnemiesGushed"	"Foes Gush'd"
"BountyHunterRank0"	"Scrounger's"
"BountyHunterRank1"	"Scavenger's"
"BountyHunterRank2"	"Shadower's"
"BountyHunterRank3"	"Trapper's"
"BountyHunterRank4"	"Hawker's"
"BountyHunterRank5"	"Ferreter's"
"BountyHunterRank6"	"Tracker's"
"BountyHunterRank7"	"Stalker's"
"BountyHunterRank8"	"Hunter's"
"BountyHunterRank9"	"Hitman's"
"BountyHunterRank10"	"Marauder's"
"BountyHunterRank11"	"Liquidator's"
"BountyHunterRank12"	"Mercenary's"
"BountyHunterRank13"	"Cutthroat's"
"BountyHunterRank14"	"Murderer's"
"BountyHunterRank15"	"Exterminator's"
"GoldRank0"	"Destitute"
"GoldRank1"	"Deprived"
"GoldRank2"	"Meager"
"GoldRank3"	"Lackin'"
"GoldRank4"	"Poor"
"GoldRank5"	"Favor'd"
"GoldRank6"	"Flourishin'"
"GoldRank7"	"Thrivin'"
"GoldRank8"	"Prosperous"
"GoldRank9"	"Boomin'"
"GoldRank10"	"Bounteous"
"GoldRank11"	"Lucrative"
"GoldRank12"	"Abundant"
"GoldRank13"	"Flush"
"GoldRank14"	"Gilded"
"GoldRank15"	"Bountiful"
"GoldRank16"	"Affluent"
"GoldRank17"	"Wealthy"
"GoldRank18"	"Opulent"
"GoldRank19"	"Palatial"
"GoldRank20"	"Triumphant"
"ThiefRank0"	"Pilferin'"
"ThiefRank1"	"Pinchin'"
"ThiefRank2"	"Riflin'"
"ThiefRank3"	"Pickpocketin'"
"ThiefRank4"	"Swindlin'"
"ThiefRank5"	"Poachin'"
"ThiefRank6"	"Divestin'"
"ThiefRank7"	"Fleecin'"
"ThiefRank8"	"Lootin'"
"ThiefRank9"	"Thievin'"
"ThiefRank10"	"Robbin'"
"ThiefRank11"	"Plunderin'"
"ThiefRank12"	"Raidin'"
"ThiefRank13"	"Ransackin'"
"ThiefRank14"	"Pillagin'"
"ThiefRank15"	"Maraudin'"
"AxeRank0"	"Peon's"
"AxeRank1"	"Flunky's"
"AxeRank2"	"Grunt's"
"AxeRank3"	"Guard's"
"AxeRank4"	"Recruit's"
"AxeRank5"	"Fighter's"
"AxeRank6"	"Warrior's"
"AxeRank7"	"Veteran's"
"AxeRank8"	"Guerilla's"
"AxeRank9"	"Enforcer's"
"AxeRank10"	"Mercenary's"
"AxeRank11"	"Warmonger's"
"AxeRank12"	"Eliminator's"
"AxeRank13"	"Executioner's"
"DOTA_Chat_DeniedAegis"	"%s1 denied th' Aegis o' th' Immortal!!"
"DOTA_create_tournament_lobby"	"CRAFT TOURNEY LOBBY"
"new_tournament_games"	"NEW"
"current_tournament_games"	"UNDERWAY"
"old_tournament_games"	"FINISHED"
"create_tournament_entry_button"	"CRAFT"
"clear_tournament_entry_button"	"WIPE"
"clear_tournament_dialog_header"	"CLEAR TOURNEY BATTLE"
"clear_tournament_dialog_body"	"Sure ye wish t' clear this 'ere battle? Any Match ID'll be wiped clean an' any existin' lobbies turn int' usual practice lobbies."
"clear_tournament_failure"	"Avast! Failed t' clear tourney battle."
"UI_Spectator_Controls"	"Controls"
"UI_Spectator_Stats"	"Rundown o' Spoils"
"DOTA_UserMenu_TeamTransferAdmin"	"Make Crew Captain"
"DOTA_SpectatorDropdown_KDA"	"Kills/Deaths/Assists"
"DOTA_SpectatorDropdown_Lasthits_Denies"	"Last Hits / Denies"
"DOTA_SpectatorDropdown_Level"	"Admiral Rank"
"DOTA_SpectatorDropdown_XP_Per_Min"	"XP Per Shot o' Rum"
"DOTA_SpectatorDropdown_Gold"	"Current Coin"
"DOTA_SpectatorDropdown_TotalGold"	"Coin Earned"
"DOTA_SpectatorDropdown_Gold_Per_Min"	"Coin Per Shot o' Rum"
"DOTA_SpectatorDropdown_Sort"	"Amend Sortin'"
"DOTA_SpectatorDropdown_Close"	"Wipe Category"
"dota_stat_dropdown"	"BATTLE SPOILS"
"dota_stat_dropdown_level"	"ADMIRAL RANK"
"dota_stat_dropdown_gold"	"COIN ON HAND"
"dota_stat_dropdown_kda"	"KILLS/DEATHS/ASSISTS"
"dota_stat_dropdown_lasthits_denies"	"LAST HITS/DENIES"
"dota_stat_dropdown_totalgold"	"TOTAL COIN EARNED"
"dota_stat_dropdown_gold_per_min"	"COIN PER SHOT O' RUM"
"dota_stat_dropdown_xp_per_min"	"XP PER SHOT O' RUM"
"generic_error_header"	"ERRARRRRR"
"dota_watch_live_tab_star"	"LIVE TOURNEY"
"dota_lobby_tab_tournament"	"TOURNEYS"
"dota_cm_game_on"	"FIGHT!"
"DOTA_SpectatorAudio_Header"	"%s1 Available"
"DOTA_RP_WATCHING_TOURNAMENT"	"Watchin' A Tourney Battle"
"DOTA_ItemTest_DisableNICE"	"Turn Off Texture Filterin'"
"DOTA_ItemTest_DisableNICE_Desc"	"On certain textures, th' NICE filter we use can cause some mipmaps that t' lose some o' th' texture detail. If ye see this happenin' with yer textures, try turnin' this option on an' see if th' textures are better lookin'."
"DOTA_ItemTest_Importing"	"IMPORTIN'"
"DOTA_ItemTest_Import_Success"	"IMPORT SUCCESSFUL"
"DOTA_ItemTest_Import_Failed"	"IMPORT FAILED"
"DOTA_SpectatorDropdown_Buyback"	"State o' Resurrection"
"dota_stat_dropdown_buyback"	"RETURN"
"new_store_items"	"NEW MARKET LOOT"
"DOTA_Lobby_Broadcast_Title"	"BROADCAST CHANNEL %s1"
"DOTA_Lobby_Penalty_Type_Radiant"	"PENALTY - TH' RADIANT"
"DOTA_Lobby_Penalty_Type_Dire"	"PENALTY - Dire"
"DOTA_Lobby_Penalty_Level_0"	"None"
"DOTA_Lobby_Penalty_Radiant"	"BUCCANEER PENALTY"
"DOTA_Lobby_Penalty_Dire"	"DIRE PENALTY"
"dota_broadcaster_title"	"Pick a Broadcaster"
"dota_broadcaster_no_selection"	"No Broadcaster"
"MD_Replay_Pending"	"Replay Pendin'"
"DOTA_Subscription_Watched"	"Seen"
"DOTA_MatchNoRating"	"Nary a vote"
"DOTA_MatchRatingLike"	"like"
"DOTA_MatchRatingLikes"	"likes"
"DOTA_MatchRatingDislike"	"dislike"
"DOTA_MatchRatingDislikes"	"dislikes"
"DOTA_MatchRatingText"	"%s1 - %s2"
"DOTA_TournamentDrop"	"%s1 'as earn'd special loot fer watchin' %s2!"
"DOTA_TournamentDrop_FirstBlood"	"first blood"
"DOTA_Chat_AegisStolen"	"%s1 snatch'd th' Aegis o' th' Immortal!"
"npc_dota_hero_medusa"	"Medusa"
"dota_chat_game_tab"	"Battle"
"DOTA_UserMenu_Swap"	"Swap Admiral"
"DOTA_Swap_Confirm_Header"	"Swap Admiral?"
"DOTA_Swap_Confirm_Message"	"Really wish t' swap yer admiral fer %s1?"
"dota_cm_game_on_label"	"BATTLE BEGINS:"
"DOTA_BackpackReplay"	"Look At th' Replay"
"DOTA_TournamentDrop_GameEnd"	"glorious victory"
"DOTA_TournamentDrop_KillStreak"	"a multi-kill"
"DOTA_TournamentDrop_HeroDeny"	"an allied admiral denial"
"DOTA_TournamentDrop_AegisDeny"	"a denial o' th' Aegis o' th' Immortal"
"DOTA_TournamentDrop_AegisStolen"	"a theft o' th' Aegis o' th' Immortal"
"LoadoutSlot_Fan_Item"	"Fan Loot"
"Attrib_MatchID"	"Battle ID: %s1"
"Attrib_GameTime"	"Time 'til Grog Fest: %s1"
"KillEaterEventType_Axe_Culls"	"Enemies Culled"
"KillEaterEventType_Axe_BattleHungerKills"	"Battle Hunger Kills"
"KillEaterEventType_Axe_LowHealthKills"	"Near Death Kills"
"KillEaterEventType_Axe_CalledDamageDone"	"Call Damage Done"
"KillEaterEventType_Axe_CalledDamageTaken"	"Call Damage Taken"
"InvokerRank1"	"Superior"
"InvokerRank2"	"Faultless"
"InvokerRank3"	"Matchless"
"InvokerRank4"	"Incomparable"
"InvokerRank5"	"Peerless"
"InvokerRank6"	"Supreme"
"InvokerRank7"	"Unequal'd"
"InvokerRank8"	"Unrival'd"
"InvokerRank9"	"Unparallel'd"
"InvokerRank10"	"Unsurpassable"
"InvokerRank11"	"Inimitable"
"InvokerRank12"	"Consummate"
"InvokerRank13"	"Preeminent"
"InvokerRank14"	"Paramount"
"InvokerRank15"	"Transcendant"
"InvokerRank16"	"Ultimate"
"InvokerRank17"	"Perfect"
"spectate_chatenabled_label"	"Lookout Parley"
"DOTA_Lobby_Series_Type"	"Series Kind"
"DOTA_No_Series"	"Nary a Series"
"DOTA_Series_Best_of_3"	"Best o' 3"
"DOTA_Series_Best_of_5"	"Best o' 5"
"DOTA_SpectatorClientMSG"	"Ye be runnin' some kind o' lookout-only version o' Dota 2."
"dota_spectator_signup"	"Get on th' list fer a free Dota 2 recruitin'"
"dota_spectator_buy"	"Acquire th' Invite Bundle from th' Dota Market"
"dota_button_signup"	"ENLIST"
"dota_button_buy"	"START PLUNDERIN'"
"ti2_sub_sched_label"	"Scour fer battles by date"
"ti2_sub_sched_desc"	"Scour all th' battles by date it happen'd. Go t' these pages t' follow Th' International spoiler-free. \n(Then avoid our Twitter feed an' Facebook posts.)"
"ti2_sub_results_label"	"Stalk battles by bracket (spoilers!)"
"international_tab"	"INTERNATIONAL"
"dota_load_game_searching"	"Scourin' fer Archived Battles..."
"dota_load_game_no_games"	"Arr, no Archived Battles found"
"DOTA_ItemTest_Error"	"Import Errarrrrr"
"DOTA_ItemTest_Error_Unskinned"	"Err, couldn't find a single bone' in th' wearable that corresponds t' bones in th' admiral model. Wearable loot must be skinned t' th' admiral's bones t' be submitt'd."
"DOTA_SpectatorDropdown_NetWorth"	"Net Worth"
"DOTA_Bundle"	"Bundle"
"DOTA_PennantUpgrade_Confirm"	"Are ye sure ye want t' upgrade this pennant?"
"ti_schedule_view"	"Schedule View"
"ti_prelim_view"	"Prelims"
"LoadoutSlot_Fan"	"Fan"
"Attrib_FanfareLevel"	"Rank: %s1"
"KillEaterEventType_GamesViewed"	"Battles Seen"
"KillEaterEventType_Sven_DoubleStuns"	"Multi-Admiral Storm Hammers"
"KillEaterEventType_Sven_WarcryAssists"	"Warcry Assists"
"KillEaterEventType_Sven_CleaveDoubleKills"	"Multi-Admiral Cleave Kills"
"dota_stat_dropdown_networth"	"NET WORTH"
"dota_title_pennant"	"DOTA Crew Pennant"
"Attrib_InternationalTag"	"Th' International %s1"
"DOTA_FanSlot"	"Scallywag Fan Slot"
"DOTA_Chat_DoubleKill_noname"	"wit' a double kill!"
"DOTA_Chat_TripleKill_noname"	"wit' a TRIPLE kill!"
"DOTA_Chat_QuadKill_noname"	"wit' an ULTRA KILL!"
"npc_dota_hero_troll_warlord"	"Troll Warlord"
"npc_dota_hero_centaur"	"Centaur Warrunner"
"npc_dota_hero_magnataur"	"Magnus"
"DOTA_HoF_Champions"	"World Champions"
"DOTA_HoF_ArtStyle"	"Ivan Antonov"
"DOTA_HoF_XBOCT"	"Oleksandr Dashkevych"
"DOTA_HoF_Dendi"	"Danil Ishutin"
"DOTA_HoF_LighTofHeaveN"	"Dmitriy Kupriyanov"
"DOTA_HoF_Zhou"	"Chen Yao"
"DOTA_HoF_Ferrari430"	"Luo Feichi"
"DOTA_HoF_YYF"	"Jiang Cen"
"DOTA_HoF_ChuaN"	"Wong Hock Chuan"
"DOTA_HoF_Faith"	"Zeng Hongda"
"DOTA_TutorialTitle_SupportItems_RingOfBasilius"	"Ring o' Basilius"
"DOTA_TutorialTitle_SupportItems_RingOfBasilius2"	"Ring o' Basilius"
"Team_EnterURL"	"Enter Crew URL"
"dota_view_teamprofile"	"See Crew Log"
"dota_team_profile_hed"	"CREW LOG"
"DOTA_Lobby_GatherTeam"	"Gather Crew"
"DOTA_Lobby_DisbandTeam"	"Disband Crew"
"Team__TAB_TEAMSLIST"	"CREWS LIST"
"social_hof_gpm"	"GPM: %s1"
"established"	"Est."
"DOTA_EggEssence_Confirm"	"Are ye sure ye want t' combine this egg wit' th' essence? If ye do this, ye can never undo it!"
"DOTA_TutorialTitle_QuestSuccess"	"Ye Win!"
"DOTA_TutorialTitle_QuestFailure"	"Ye Lose!"
"UI_JUST_FRIENDS"	"JUST MATEYS"
"DOTA_Tooltip_Econ_halloween_red"	"EXORT"
"DOTA_Tooltip_Econ_halloween_yellow"	"WEX"
"DOTA_Tooltip_Econ_halloween_blue"	"QUAS"
"npc_dota_hero_shredder"	"Timbersaw"
"show_player_activity"	"SCALLYWAG ACTIVITY"
"DOTA_Egg_Confirm"	"Are ye sure ye want t' hatch t'is egg?"
"npc_dota_hero_bristleback"	"Bristleback"
"Store_SortBy"	"Tidy-up by:"
"Attrib_FrostivusTag"	"Frostivus %s1"
"DOTA_Play_Tab_Xmas"	"Th' Greevilin'"
"DOTA_Find_Greevilling_Match"	"TH' GREEVILIN'"
"npc_dota_hero_tusk"	"Tusk"
"npc_dota_hero_skywrath_mage"	"Skywrath Mage"
"npc_dota_hero_abaddon"	"Abaddon"
"npc_dota_hero_elder_titan"	"Elder Titan"
"npc_dota_hero_legion_commander"	"Legion Commander"
"game_mode_0_desc"	"-"
"game_mode_6_desc"	"-"
"Econ_Store_PurchaseType_Standard"	"%s1"
"UI_days"	"sunrises"
"UI_minutes"	"shots o' rum"
"UI_seconds"	"grains o' sand"
"DOTA_Tutorial_Archronicus_Page1"	"Archronicus"
"DOTA_Filter_CloseRule"	"Belay"
"DOTA_AddFriends_Cancel"	"Belay"
"npc_dota_hero_ember_spirit"	"Ember Spirit"
"npc_dota_hero_earth_spirit"	"Earth Spirit"
"fantasy_swap_player_cancel"	"Belay"
"DOTA_Invite_Cancel"	"BELAY"
}
}
