"lang"
{
"Language"	"latam"
"Tokens"
{
"AbilityDuration"	"DURACIÓN:"
"AbilityDamage"	"DAÑO:"
"AddToCollection"	"Coleccionar objeto"
"Attrib_InternationalTag"	"The International %s1"
"announcer"	"Locutor"
"ActivateProgram"	"Activar pase de batalla"
"1OTA_TIP_2013_TeamCountry_1"	"China"
"Algid_Legacy_Default"	"Estilo predeterminado"
"Algid_Legacy_Particle"	"Mejora de efecto ambiental"
"DOTA_Style_The_Lightning_Orchid_Retro_0"	"Renacido"
"DOTA_Style_The_Lightning_Orchid_Retro_1"	"Excepcional"
"DOTA_Style_Leviathan_Whale_Blade_Retro_0"	"Renacido"
"DOTA_Style_Leviathan_Whale_Blade_Retro_1"	"Excepcional"
"DOTA_Style_Fin_Kings_Charm_Retro_0"	"Renacido"
"DOTA_Style_Fin_Kings_Charm_Retro_1"	"Excepcional"
"DOTA_Style_Tormented_Staff_Retro_0"	"Renacido"
"DOTA_Style_Tormented_Staff_Retro_1"	"Excepcional"
"DOTA_Style_Cauldron_of_Xahryx_Retro_0"	"Renacido"
"DOTA_Style_Cauldron_of_Xahryx_Retro_1"	"Excepcional"
"dota_tip_lore_1"	"Atos, el Señor de la Plaga, tiene un fragmento de su esencia almacenado en la Vara de Atos."
"dota_tip_lore_4"	"Crystal Maiden y Lina son hermanas."
"dota_tip_hero_slark_1"	"Mientras está bajo el efecto de Baile de Sombras, Slark no puede ser revelado por visión verdadera."
"dota_tip_hero_phoenix_1"	"Phoenix puede usar objetos y lanzar habilidades durante Picado de Ícaro."
"dota_tip_hero_arc_warden_1"	"Campo Magnético de Arc Warden otorga evasión a los aliados que se encuentran dentro del campo frente a los ataques que vienen de fuera de él, incluyendo los ataques de torres."
}
}
